a	a,à,á,ã,ạ,ả,a
a1	a1
a10	a10
a113	a113
a115	a115
a2	a2
a3	a3
a4	a4
a5	a5
a523	a523
a6	a6
a60	a60
a7	a7
a8	a8
aa	aa
aac	aac
abarth	abarth
ac	ác,ắc
acadia	acadia
accent	accent
accord	accord
ace	ace
ach	ách,ạch
activehicle	activehicle
activehybrid	activehybrid
activity	activity
acty	acty
actyon	actyon
acura	acura
acv	acv
admiral	admiral
adventure	adventure
aerio	aerio
aero	aero
aerostar	aerostar
aerovette	aerovette
agila	agila
ai	ai,ái,ải
air	air
airflite	airflite
al2	al2
albea	albea
alero	alero
alfa	alfa
alfasud	alfasud
alfetta	alfetta
allante	allante
allion	allion
allroad	allroad
almera	almera
alphard	alphard
alpina	alpina
alterra	alterra
altezza	altezza
altima	altima
altis	altis
alto	alto
am	am,ám,âm,ăm,ảm,ấm,ầm,ẩm,ẫm,ậm,ẵm
amanti	amanti
amaze	amaze
america	america
americana	americana
amg	amg
amigo	amigo
ampera	ampera
an	an,án,ân,ăn,ấn,ẩn
and	and
ang	ang,áng,ăng,ảng,ắng,ẳng
anglia	anglia
anh	anh,ánh,ảnh
antara	antara
antser	antser
ao	ao,ào,áo,ảo
ap	áp,ấp,ập,ắp
applause	applause
apv	apv
ar	ar
arcadia	arcadia
arena	arena
argenta	argenta
argento	argento
aria	aria
aristo	aristo
armada	armada
armadillo	armadillo
arna	arna
arnage	arnage
artic	artic
ascender	ascender
ascona	ascona
aspen	aspen
aspire	aspire
asso	asso
aston	aston
astra	astra
astro	astro
astrovette	astrovette
asx	asx
at	át,ạt,ất,ắt
atenza	atenza
ateva	ateva
atlantic	atlantic
atom	atom
atos	atos
atrai	atrai
ats	ats
au	au,âu,ấu,ầu,ẩu,ậu
audi	audi
auris	auris
aurora	aurora
autonomy	autonomy
avalanche	avalanche
avalon	avalon
avancier	avancier
avantissimo	avantissimo
avanza	avanza
avella	avella
avenger	avenger
avenir	avenir
avensis	avensis
aventador	aventador
avenue	avenue
aveo	aveo
aviat	aviat
aviator	aviator
avus	avus
axiom	axiom
ay	áy,ấy,ẩy
aygo	aygo
az	az
azera	azera
azure	azure
b	b
b2200	b2200
b2300	b2300
b2500	b2500
b3000	b3000
b4000	b4000
b7	b7
b9	b9
ba	ba,bà,bá,bã,bạ,bả
bac	bác,bạc,bấc,bậc,bắc
bach	bách,bạch
bai	bai,bài,bái,bãi,bại,bải
baic	baic
baja	baja
baleno	baleno
ballade	ballade
bam	bám,băm,bấm,bầm,bẩm,bẫm,bậm,bằm,bẳm,bẵm,bặm
ban	ban,bàn,bán,bân,băn,bạn,bản,bấn,bần,bẩn,bận,bắn,bằn,bẳn,bặn
bandeirante	bandeirante
bang	bang,bàng,báng,bâng,băng,bạng,bảng,bấng,bắng,bằng,bẵng,bặng
banh	banh,bành,bánh,bạnh,bảnh
bantam	bantam
bao	bao,bào,báo,bão,bạo,bảo
bap	bạp,bấp,bập,bắp,bặp
barchetta	barchetta
baron	baron
bat	bát,bạt,bất,bật,bắt,bặt
bata	bata
bau	bàu,báu,bâu,bạu,bảu,bấu,bầu,bẩu,bậu
bay	bay,bày,bây,bảy,bấy,bầy,bẩy,bẫy,bậy
bb	bb
bbi	bbi
be	be,bè,bé,bê,bẹ,bẻ,bẽ,bế,bề,bể,bễ,bệ
bear	bear
bec	béc,bẹc
bech	bệch
bee	bee
beetle	beetle
bel	bel
bella	bella
bellel	bellel
bellett	bellett
bem	bem,bèm,bẻm
ben	ben,bèn,bén,bên,bẹn,bẽn,bến,bền,bển,bện
beng	beng,béng
benh	bênh,bềnh,bệnh
benni	benni
bentley	bentley
benz	benz
beo	beo,bèo,béo,bẹo,bẻo,bẽo
bep	bép,bẹp,bếp
beretta	beretta
berlina	berlina
berline	berline
berlinetta	berlinetta
besta	besta
bet	bét,bẹt,bết,bệt
beu	bêu,bều,bệu
bi	bi,bì,bí,bĩ,bỉ,bị
bia	bia,bìa,bịa
biarritz	biarritz
bich	bích,bịch
biec	biếc
biem	biếm
bien	biên,biến,biền,biển,biện
bieng	biếng
biet	biết,biệt
bieu	biếu,biểu
bim	bìm,bím
bin	bin,bịn
binh	binh,bình,bính,bĩnh,bỉnh,bịnh
bionic	bionic
bip	bíp,bịp
biscayne	biscayne
bit	bít,bịt
biturbo	biturbo
biu	bìu,bíu,bĩu,bỉu,bịu
blackwood	blackwood
blazer	blazer
blizzard	blizzard
bls	bls
bluebird	bluebird
bmw	bmw
bo	bo,bò,bó,bô,bõ,bơ,bọ,bỏ,bố,bồ,bổ,bỗ,bộ,bớ,bờ,bở,bỡ,bợ
boa	boa
boc	bóc,bọc,bốc,bộc
boi	bói,bôi,bơi,bỏi,bối,bồi,bổi,bội,bới,bời,bởi
bolero	bolero
bom	bom,bôm,bõm,bơm,bỏm,bồm,bờm,bợm
bon	bon,bòn,bón,bôn,bơn,bọn,bốn,bồn,bổn,bộn,bỡn,bợn
bong	bong,bòng,bóng,bông,bõng,bọng,bỏng,bống,bồng,bổng,bỗng,bộng
boong	boong,boóng
bop	bóp,bốp,bộp,bớp,bợp
bora	bora
borrego	borrego
bot	bót,bọt,bốt,bột,bớt,bợt
box	box
boxster	boxster
br	br
brand	brand
brava	brava
bravo	bravo
break	break
brera	brera
brevis	brevis
brio	brio
brisa	brisa
bronco	bronco
brooklands	brooklands
brougham	brougham
brown	brown
brz	brz
bt	bt
bu	bu,bù,bú,bụ,bủ,bứ,bự
bua	bua,bùa,búa,bụa,bủa,bứa,bừa,bửa,bữa,bựa
buc	bục,bức,bực
bui	bùi,búi,bụi
bum	bùm,bụm
bun	bùn,bún,bủn
bung	bung,bùng,búng,bưng,bụng,bủng,bứng,bừng,bửng,bựng
buoc	buộc,bước
buoi	buồi,buổi,bươi,bưởi
buom	buồm,buộm,bươm,bướm
buon	buôn,buồn,bươn
buong	buông,buồng,bương,bướng
buop	bướp
buot	buốt,buột
buou	bươu,bướu
bup	búp,bụp
but	bút,bụt,bứt,bựt
buu	bưu,bửu
buyt	buýt
byd	byd
c	c
c2	c2
c200	c200
c220	c220
c30	c30
c62	c62
c70	c70
ca	ca,cà,cá,cạ,cả
cab	cab
cabriolet	cabriolet
cac	các,cạc,cấc,cắc,cặc
cach	cách,cạch
caddy	caddy
cadenza	cadenza
cadillac	cadillac
cai	cai,cài,cái,cãi,cải
caimano	caimano
calais	calais
caldina	caldina
caliber	caliber
calibra	calibra
california	california
cam	cam,cám,câm,căm,cạm,cảm,cấm,cầm,cẩm,cẫm,cắm,cằm,cặm
camaro	camaro
cambiocorsa	cambiocorsa
camino	camino
campagnola	campagnola
camry	camry
can	can,càn,cán,cân,căn,cạn,cản,cấn,cần,cẩn,cẫn,cận,cắn,cằn,cẳn,cặn
cang	cang,càng,cáng,câng,căng,cảng,cẫng,cẳng
canh	canh,cành,cánh,cạnh,cảnh
cantera	cantera
canyon	canyon
cao	cao,cào,cáo,cạo,cảo
cap	cáp,cạp,cấp,cập,cắp,cặp
capa	capa
capital	capital
cappuccino	cappuccino
capri	capri
caprice	caprice
captiva	captiva
car	car
carabo	carabo
caravan	caravan
caravelle	caravelle
carens	carens
carenslx	carenslx
careza	careza
carina	carina
carisma	carisma
carlo	carlo
carnival	carnival
carol	carol
carrera	carrera
carry	carry
carry1	carry1
carry2	carry2
caserta	caserta
cat	cát,cất,cật,cắt,cặt
catera	catera
cau	cau,càu,cáu,câu,cạu,cảu,cấu,cầu,cẩu,cậu
cavalier	cavalier
cay	cay,cày,cáy,cây,cạy,cấy,cầy,cậy
cayenne	cayenne
cayman	cayman
cc	cc
ccv	ccv
cedric	cedric
cee	cee
ceed	ceed
cefiro	cefiro
celebrity	celebrity
celerio	celerio
celeste	celeste
celica	celica
celsior	celsior
celta	celta
centauri	centauri
centura	centura
century	century
cerato	cerato
ceres	ceres
cervo	cervo
cha	cha,chà,chá,chã,chạ,chả
chac	chác,chạc,chậc,chắc,chặc
chach	chách,chạch
chai	chai,chài,chái,chãi,chải
chairman	chairman
challenger	challenger
cham	chàm,châm,chăm,chạm,chấm,chầm,chẩm,chẫm,chậm,chắm,chằm,chặm
chan	chan,chán,chân,chăn,chạn,chấn,chần,chẩn,chận,chắn,chằn,chẵn,chặn
chana	chana
chang	chang,chàng,cháng,châng,chăng,chạng,chằng,chẳng,chặng
chanh	chanh,chành,chánh,chạnh
chante	chante
chao	chao,chào,cháo,chão,chạo,chảo
chap	chạp,chấp,chập,chắp,chặp
chappo	chappo
charade	charade
charger	charger
charmant	charmant
chaser	chaser
chat	chát,chạt,chất,chật,chắt,chặt
chateau	chateau
chau	chau,cháu,châu,chảu,chấu,chầu,chẩu,chẫu,chậu
chay	chay,chày,cháy,chây,chạy,chảy,chấy,chầy
che	che,chè,ché,chê,chẻ,chẽ,chế,chề,chệ
chech	chếch,chệch
chem	chèm,chém,chêm,chếm
chen	chen,chèn,chén,chẹn,chẽn,chện
cheng	cheng,chẻng
chenh	chênh,chếnh,chềnh,chểnh,chễnh,chệnh
cheo	cheo,chèo,chéo,chẹo,chẻo
chep	chép
cherokee	cherokee
cherry	cherry
chery	chery
chet	chét,chẹt,chết
chevelle	chevelle
chevette	chevette
chevrolet	chevrolet
cheyenne	cheyenne
chi	chi,chì,chí,chỉ,chị
chia	chia,chìa,chĩa,chịa
chich	chích
chiec	chiếc
chiem	chiêm,chiếm
chien	chiên,chiến,chiền,chiện
chieng	chiêng,chiếng,chiềng
chiep	chiếp
chiet	chiết
chieu	chiêu,chiếu,chiều,chiểu
chim	chim,chìm,chím
chin	chín,chĩn,chỉn
chinh	chinh,chình,chính,chĩnh,chỉnh
chit	chít,chịt
chiu	chiu,chíu,chịu
cho	cho,chò,chó,chõ,chơ,chỏ,chồ,chỗ,chộ,chớ,chờ,chở,chợ
choa	choa,chóa
choac	choác,choạc
choai	choai,choài,choái,choãi,choại
choan	choán
choang	choang,choàng,choáng,choạng,choảng
choat	choắt
choc	chóc,chọc,chốc
choe	choe,chòe,chóe,chọe
choen	choen,choèn
choet	choẹt
choi	choi,chòi,chói,chơi,chọi,chỏi,chối,chồi,chổi,chỗi,chội,chới,chợi
chom	chòm,chôm,chõm,chơm,chỏm,chồm,chỗm,chớm,chờm,chởm
chon	chon,chôn,chơn,chọn,chỏn,chốn,chồn,chộn,chớn,chờn,chợn
chong	chong,chòng,chóng,chông,chõng,chỏng,chống,chồng,chổng
choong	choòng
chop	chóp,chốp,chộp,chớp,chợp
chot	chót,chọt,chốt,chột,chớt
chronos	chronos
chrysler	chrysler
chu	chu,chù,chú,chư,chủ,chứ,chừ,chữ
chua	chua,chùa,chúa,chưa,chứa,chừa,chửa,chữa
chuan	chuẩn
chuc	chúc,chục,chức,chực
chuech	chuệch
chuenh	chuếnh,chuệnh
chui	chui,chùi,chúi,chũi,chửi
chum	chum,chùm,chúm,chũm,chụm
chun	chun,chùn,chũn,chưn,chủn
chung	chung,chùng,chúng,chưng,chủng,chứng,chừng,chửng,chững,chựng
chuoc	chuốc,chuộc,chước,chược
chuoi	chuôi,chuối,chuồi,chuỗi,chuội
chuom	chuôm,chườm
chuon	chuồn
chuong	chuông,chuồng,chuộng,chương,chướng,chường,chưởng,chưỡng
chuop	chượp
chuot	chuốt,chuột
chup	chụp
chut	chút,chụt
chuy	chùy
chuyen	chuyên,chuyến,chuyền,chuyển,chuyện
ciaz	ciaz
cima	cima
cimarron	cimarron
cinquecento	cinquecento
cirrus	cirrus
citation	citation
citi	citi
city	city
civic	civic
cj	cj
cj2	cj2
cj2a	cj2a
cj3a	cj3a
cj5	cj5
cj7	cj7
cl	cl
cla	cla
clarus	clarus
class	class
clix	clix
clk	clk
clk55	clk55
cls	cls
clubman	clubman
co	co,cò,có,cô,cơ,cọ,cỏ,cố,cồ,cổ,cỗ,cộ,cớ,cờ,cỡ
coaster	coaster
cobalt	cobalt
coc	cóc,cọc,cốc,cộc
coi	coi,còi,cói,côi,cõi,cơi,cỏi,cối,cổi,cỗi,cội,cời,cởi,cỡi
coin	coin
collection	collection
colorado	colorado
colt	colt
com	com,còm,cóm,côm,cơm,cọm,cỏm,cốm,cồm,cộm,cớm,cỡm,cợm
combo	combo
comet	comet
commander	commander
commodore	commodore
comodoro	comodoro
compadre	compadre
compagno	compagno
compass	compass
competizione	competizione
con	con,còn,cón,côn,cơn,cọn,cỏn,cốn,cồn,cổn,cộn,cớn,cỡn,cợn
concept	concept
concerto	concerto
concorde	concorde
condor	condor
cong	cong,còng,cóng,công,cõng,cọng,cống,cồng,cổng,cộng
connect	connect
conquest	conquest
consorte	consorte
consul	consul
continental	continental
contour	contour
convertible	convertible
cooc	coóc
cool	cool
cooper	cooper
cop	cóp,cọp,cốp,cộp,cợp
copen	copen
copperhead	copperhead
cordoba	cordoba
corolla	corolla
corona	corona
coronet	coronet
corrado	corrado
corsa	corsa
corsair	corsair
corsica	corsica
cortina	cortina
corvair	corvair
corvette	corvette
cosmo	cosmo
cot	cót,cọt,cốt,cột,cớt,cợt
cougar	cougar
country	country
countryman	countryman
coupe	coupe
courier	courier
covie	covie
cowin	cowin
cowry	cowry
cr	cr
cressida	cressida
cresta	cresta
crestline	crestline
crew	crew
croma	croma
cross	cross
crosscabriolet	crosscabriolet
crossfire	crossfire
crosstour	crosstour
crosswind	crosswind
crown	crown
cruiser	cruiser
cruze	cruze
crx	crx
cs	cs
csx	csx
ct	ct
ct200h	ct200h
cts	cts
cu	cu,cù,cú,cũ,cư,cụ,củ,cứ,cừ,cử,cữ,cự
cua	cua,cưa,của,cứa,cửa,cựa
cube	cube
cuc	cúc,cục,cức,cực
cui	cui,cùi,cúi,cũi,cụi,củi,cửi
cum	cum,cùm,cúm,cụm,củm
cun	cun,cùn,cún,cũn,củn
cuneo	cuneo
cung	cung,cùng,cúng,cũng,cưng,cụng,củng,cứng
cuoc	cuốc,cuộc,cước,cược
cuoi	cuối,cuội,cưới,cười,cưỡi
cuom	cuỗm,cườm
cuon	cuốn,cuồn,cuộn
cuong	cuông,cuống,cuồng,cuộng,cương,cường,cưỡng
cuop	cướp
cuore	cuore
cup	cúp,cụp
custom	custom
cut	cút,cụt,cứt
cuu	cưu,cứu,cừu,cửu,cữu,cựu
cx	cx
cyclone	cyclone
cygnet	cygnet
d	d
d6	d6
da	da,dà,dá,dã,dạ,dả
dac	dác,dạc,dặc
dach	dách
daewoo	daewoo
dai	dai,dài,dái,dãi,dại,dải
daihatsu	daihatsu
dakar	dakar
dakota	dakota
dam	dam,dàm,dám,dâm,dăm,dạm,dấm,dầm,dẫm,dậm,dằm,dặm
dan	dan,dàn,dán,dân,dãn,dăn,dạn,dấn,dần,dẩn,dẫn,dận,dằn,dẳn,dặn
dang	dang,dàng,dáng,dâng,dăng,dạng,dắng,dằng,dẳng,dặng
danh	danh,dành,dảnh
dao	dao,dào,dáo,dạo
dap	dấp,dập
dardo	dardo
dart	dart
dat	dát,dạt,dật,dắt,dặt
dau	dàu,dâu,dấu,dầu,dẩu,dẫu,dậu
dawn	dawn
day	day,dày,dáy,dây,dãy,dạy,dảy,dấy,dầy,dẩy,dẫy,dậy
daytona	daytona
db2	db2
db3	db3
db4	db4
db5	db5
db6	db6
db7	db7
db9	db9
dbr2	dbr2
dbs	dbs
de	de,dè,dé,dê,dẻ,dẽ,dế,dề,dể,dễ,dệ
debonair	debonair
dech	dệch
defender	defender
del	del
delica	delica
delta	delta
deluxe	deluxe
dem	dém
demio	demio
den	den,dèn,dền,dện
denh	dênh,dềnh
deo	deo,dẻo
dep	dép,dẹp
derby	derby
desert	desert
det	dẹt,dết,dệt
deville	deville
di	di,dì,dí,dĩ,dị,di
dia	dìa,dĩa
diamante	diamante
dich	dịch
diec	diếc,diệc
diem	diềm,diễm,diệm
dien	diên,diễn,diện
dieng	diềng
diep	diếp,diệp
diet	diết,diệt
dieu	diêu,diếu,diều,diễu,diệu
dim	dim,dìm,dím
din	din,dĩn
dingo	dingo
dinh	dinh,dính,dĩnh
dino	dino
dion	dion
dip	díp,dịp
diplomat	diplomat
disco	disco
discovery	discovery
dit	dịt
diu	dìu,díu,dịu
dl	dl
do	do,dò,dó,dô,dơ,dọ,dỏ,dồ,dỗ,dớ,dờ,dở,dỡ,dợ
doa	doa,dóa,dọa
doai	doãi
doan	doãn
doanh	doanh,doành
doblo	doblo
doc	dóc,dọc,dốc,dộc
dodge	dodge
doi	doi,dòi,dói,dôi,dõi,dơi,dọi,dối,dồi,dổi,dỗi,dội,dời
dom	dom,dòm,dóm,dỏm,dổm,dợm
domino	domino
don	don,dơn,dọn,dồn,dớn,dờn,dợn
dong	dong,dòng,dóng,dông,dõng,dọng,dỏng,dồng,dộng,dong
dop	dọp,dộp,dớp
dot	dốt,dột
double	double
dream	dream
drifter	drifter
drifterx	drifterx
ds	ds
dts	dts
du	du,dù,dư,dụ,dứ,dừ,dử,dữ,dự
dua	dua,dùa,dúa,dũa,dưa,dứa,dừa,dựa
duc	dục,dức,dực
ducato	ducato
due	duệ
duenh	duềnh
duett	duett
dui	dùi,dúi,dũi,dụi,dủi
dum	dúm,dụm
dump	dump
dun	dun,dùn,dún
duna	duna
dung	dung,dùng,dúng,dũng,dưng,dụng,dứng,dừng,dửng,dựng
duoc	duốc,duộc,dược
duoi	duôi,duối,duỗi,dưới,dượi
duon	dướn
duong	dương,dướng,dường,dưỡng,dượng
duot	dượt
durango	durango
dut	dút,dụt,dứt
duty	duty
duy	duy
duyen	duyên
duyet	duyệt
dyna	dyna
dynasty	dynasty
dzire	dzire
e	e,è,é,ê,ẹ,ế,ề,e
e20	e20
e220	e220
e420	e420
e5	e5
e500	e500
eagle	eagle
ec	éc,ẹc
ec7	ec7
ec8	ec8
ech	ếch,ệch
echo	echo
eclipse	eclipse
ecobasic	ecobasic
econoline	econoline
econovan	econovan
ecosport	ecosport
edge	edge
eight	eight
ek	ek
el	el
elan	elan
elantra	elantra
eldorado	eldorado
element	element
elf	elf
elise	elise
elr	elr
em	em,ém,êm,ếm
emgrand	emgrand
en	en,én,ẻn
endeavor	endeavor
energi	energi
enforcer	enforcer
eng	eng
enh	ềnh,ễnh
entourage	entourage
envoy	envoy
enzo	enzo
eo	eo,èo,éo,ẹo,ẻo,ẽo
eon	eon
eos	eos
ep	ép,ẹp
epica	epica
equator	equator
equinox	equinox
equus	equus
ertiga	ertiga
es	es
escalade	escalade
escapade	escapade
escape	escape
escort	escort
escudo	escudo
espero	espero
estate	estate
esteem	esteem
esv	esv
esx	esx
et	ét,ẹt
etude	etude
etx415	etx415
eu	êu
eunos	eunos
euro	euro
eurovan	eurovan
ev	ev
ev1	ev1
evanda	evanda
everest	everest
evolution	evolution
evolv	evolv
evoque	evoque
evora	evora
ex	ex
ex7	ex7
exalta	exalta
excel	excel
excursion	excursion
executive	executive
exige	exige
exp	exp
expedition	expedition
expert	expert
explorer	explorer
express	express
expresso	expresso
extreme	extreme
f	f
f0	f0
f1	f1
f12	f12
f1300	f1300
f2	f2
f200	f200
f3	f3
f300	f300
f310	f310
f333	f333
f355	f355
f399	f399
f40	f40
f430	f430
f5	f5
f50	f50
f512	f512
f55	f55
f550	f550
fairlady	fairlady
fairlane	fairlane
falcon	falcon
familia	familia
faw	faw
fb	fb
fb02	fb02
fchv	fchv
fcx	fcx
fe	fe
fellow	fellow
feng	feng
feroza	feroza
ferrari	ferrari
festiva	festiva
ff	ff
fiat	fiat
field	field
fiesta	fiesta
filo	filo
fiorano	fiorano
fiorino	fiorino
firebird	firebird
fit	fit
five	five
fj	fj
fleetwood	fleetwood
flex	flex
flexa	flexa
florian	florian
florid	florid
flv	flv
flying	flying
focus	focus
foison	foison
ford	ford
forenza	forenza
forester	forester
formula	formula
forte	forte
fortuner	fortuner
foton	foton
fourtrak	fourtrak
fox	fox
fr	fr
freeclimber	freeclimber
freelander	freelander
freema	freema
freemont	freemont
freestar	freestar
freestyle	freestyle
friendee	friendee
frogster	frogster
fronte	fronte
frontera	frontera
frontier	frontier
fstar	fstar
fto	fto
fuego	fuego
fulwin2	fulwin2
funcargo	funcargo
fusca	fusca
fusion	fusion
fuya	fuya
fuzion	fuzion
fw	fw
fxs	fxs
g	g
g35	g35
g3x	g3x
g4	g4
ga	ga,gà,gá,gã,gạ,gả
gac	gác,gạc,gấc,gặc
gach	gạch
gai	gai,gài,gái,gãi,gại
galant	galant
galaxie	galaxie
galaxy	galaxy
galloper	galloper
gam	gam,găm,gấm,gầm,gẩm,gẫm,gậm,gắm,gằm,gặm
gan	gan,gàn,gán,gân,gạn,gần,gắn,gằn,gặn
gang	gang,gàng,găng,gắng,gẵng,gặng
ganh	ganh,gành,gánh,gạnh,gảnh
gao	gao,gào,gáo,gạo
gap	gáp,gấp,gập,gắp,gặp
gat	gạt,gật,gắt,gặt
gato	gato
gau	gau,gàu,gáu,gâu,gấu,gầu,gẫu
gaus	gaus
gay	gay,gày,gáy,gây,gãy,gạy,gảy,gấy,gầy,gẩy,gẫy,gậy
gear	gear
geely	geely
gemini	gemini
gen	gen
genesis	genesis
getz	getz
ghe	ghe,ghè,ghé,ghê,ghẹ,ghẻ,ghẽ,ghế,ghề
ghech	ghếch,ghệch
ghem	ghém
ghen	ghen,ghèn
ghenh	ghềnh,ghểnh
gheo	ghẹo
ghep	ghép
ghet	ghét,ghệt
ghi	ghi,ghì
ghia	ghia
ghibli	ghibli
ghiec	ghiếc
ghien	ghiền
ghim	ghim,ghìm
ghinh	ghính
ghit	ghịt
ghost	ghost
gi	gi,gì,gí,gỉ
gia	gia,già,giá,giã,giạ,giả
giac	giác,giấc,giặc
giai	giai,giãi,giại,giải
giam	giam,giám,giâm,giăm,giạm,giảm,giấm,giầm,giẫm,giậm,giằm,giẵm,giặm
gian	gian,giàn,gián,giãn,giản,giấn,giần,giận,giằn,giặn
giang	giang,giàng,giáng,giăng,giạng,giảng,giằng
gianh	gianh,giành,giảnh
giao	giao,giáo,giảo
giap	giáp,giạp,giấp,giập
giat	giát,giạt,giật,giắt,giặt
giau	giàu,giâu,giảu,giấu,giầu,giậu
giay	giày,giây,giãy,giấy,giầy,giẫy
gich	gích
gie	gie,gié,giê,giẻ
giec	giếc
giem	gièm,giếm
gien	gien,giền
gieng	giêng,giếng,giềng
gieo	gieo,giéo,giẹo
giep	giẹp
giet	giết
gieu	giễu
gin	gin,gìn
gio	gio,giò,gió,giô,giơ,giọ,giỏ,giồ,giỗ,giờ,giở
gioc	gióc
gioi	gioi,giòi,giói,giọi,giỏi,giối,giồi,giổi,giỗi,giội,giới,giời
gion	gion,giòn,giôn,giỏn,giờn,giỡn
giong	giong,gióng,giông,giọng,giỏng,giống,giồng
giop	giộp
giot	giọt,giốt
gip	gíp
giu	giú,giũ,giữ
giua	giũa,giụa,giữa
giuc	giục
giui	giùi,giúi,giụi,giủi
giulia	giulia
giulietta	giulietta
gium	giùm
giun	giun
giuoc	giuộc
giuong	giương,giướng,giường
giup	giúp
giut	giựt
gl	gl
gli	gli
glk	glk
gloria	gloria
gmc	gmc
go	go,gò,gô,gõ,gơ,gọ,gồ,gổ,gỗ,gộ,gờ,gở,gỡ
goa	góa
goc	góc,gốc,gộc
goi	gọi,gỏi,gối,gồi,gội,gởi,gợi
gol	gol
golf	golf
gom	gom,gôm,gốm,gồm,gớm,gờm
gon	gon,gòn,gôn,gọn,gờn,gợn
gong	gông,gọng,gỏng,gồng
goong	goòng
gop	góp,gộp
got	gót,gọt,gột,gợt
gp	gp
gr	gr
graduate	graduate
gran	gran
granada	granada
grancabrio	grancabrio
grand	grand
grande	grande
grandeur	grandeur
grandis	grandis
granturismo	granturismo
granvia	granvia
gratour	gratour
great	great
gs	gs
gs460	gs460
gsx	gsx
gt	gt
gt1	gt1
gt2	gt2
gt3	gt3
gt4	gt4
gt500	gt500
gta	gta
gtb	gtb
gtc	gtc
gtd	gtd
gte	gte
gti	gti
gto	gto
gtr	gtr
gts	gts
gtv	gtv
gu	gu,gù,gụ,gừ
gua	gùa
guard	guard
guc	gục
gui	gùi,gũi,gụi,gửi
gun	gùn
gung	gùng,gừng
guoc	guốc,guộc
guom	gươm,gườm,gượm
guon	guộn
guong	guồng,gương,gưỡng,gượng
guot	guột
gut	gút
gx	gx
h	h
h1	h1
h2	h2
h3	h3
h30	h30
h5	h5
ha	ha,hà,há,hạ,hả
hac	hác,hạc,hắc,hặc
hach	hách,hạch
hai	hai,hài,hái,hãi,hại,hải
haima	haima
haise	haise
ham	ham,hàm,hám,hâm,hãm,hăm,hạm,hấm,hầm,hẩm,hậm,hằm,hẳm,hặm
han	han,hàn,hán,hân,hãn,hạn,hấn,hận,hắn,hằn,hẳn
hang	hang,hàng,háng,hãng,hăng,hạng,hảng,hẩng,hẫng,hắng,hằng,hẵng
hanh	hanh,hành,hánh,hãnh,hạnh,hảnh
hao	hao,hào,háo,hão,hạo,hảo
hap	háp,hạp,hấp,hập
hardbody	hardbody
hat	hát,hạt,hất,hắt
hatric	hatric
hau	hau,hàu,háu,hâu,hấu,hầu,hẩu,hẫu,hậu
haval	haval
hay	hay,háy,hây,hãy,hấy,hầy,hẩy
hcd	hcd
hd	hd
he	he,hè,hé,hê,hẹ,hề,hể,hễ,hệ
head	head
hec	héc
hech	hếch,hệch
hed	hed
hele	hele
hem	hem,hèm,hẻm,hẽm
hemi	hemi
hen	hen,hèn,hén,hên,hẹn,hẻn,hến,hển
henh	hênh,hềnh,hểnh
heo	heo,hèo,héo,hẻo
hep	hẹp
het	hét,hết,hệt
heu	hếu
hhr	hhr
hi	hi,hì,hí,hĩ,hỉ,hi
hia	hia
hiace	hiace
hich	hích,hịch
hiem	hiếm,hiềm,hiểm
hien	hiên,hiến,hiền,hiển,hiện
hieng	hiêng,hiếng
hiep	hiếp,hiệp
hiet	hiệt
hieu	hiếu,hiểu,hiệu
highlander	highlander
hilux	hilux
him	him,hĩm
hin	hin
hinh	hình,hĩnh,hỉnh
hip	híp
hit	hít
hiu	hiu
hivan	hivan
ho	ho,hò,hó,hô,hơ,họ,hỏ,hố,hồ,hổ,hỗ,hộ,hớ,hờ,hở,hỡ
hoa	hoa,hòa,hóa,họa,hỏa
hoac	hoác,hoắc,hoặc
hoach	hoạch
hoai	hoai,hoài,hoại,hoải
hoam	hoắm
hoan	hoan,hoàn,hoán,hoãn,hoạn,hoằn,hoẳn
hoang	hoang,hoãng,hoăng,hoảng,hoẵng
hoanh	hoành,hoánh,hoạnh,hoảnh
hoat	hoạt,hoắt
hoay	hoay,hoáy
hoc	hóc,học,hốc,hộc
hoe	hoe,hòe,họe
hoen	hoen,hoẻn
hoet	hoét
hoi	hoi,hòi,hói,hôi,hơi,hỏi,hối,hồi,hổi,hội,hời,hởi,hỡi,hợi
hom	hom,hòm,hóm,hôm,hõm,hỏm,hổm,hớm,hờm,hợm
hombre	hombre
hon	hon,hòn,hôn,hơn,hỏn,hồn,hổn,hỗn,hộn,hớn,hờn,hởn
honda	honda
hong	hong,hòng,hóng,hông,họng,hỏng,hống,hồng,hổng,hỗng
hop	hóp,họp,hộp,hớp,hợp
hot	hót,hốt,hột,hớt,hợt
howler	howler
hp	hp
hr	hr
hs	hs
hsr	hsr
hu	hu,hù,hú,hũ,hư,hụ,hủ,hứ,hừ,hử,hữ,hự
hua	hua,hùa,hứa
huan	huân,huấn
huc	húc,hục,hức,hực
hue	huê,huế,huề,huệ
huech	huếch
huenh	huênh
hui	hui,hùi,húi,hụi,hủi
hum	hum,hùm,hũm,hụm,hừm
hummer	hummer
hun	hun,hùn,hủn
hunaudieres	hunaudieres
hundred	hundred
hung	hung,hùng,húng,hưng,hứng,hừng,hửng,hững
hunter	hunter
huo	huơ
huoc	hước
huom	hươm,hườm,hượm
huon	hươn
huong	huống,hương,hướng,hường,hưởng
huot	huốt
huou	hươu
hup	húp,hụp
huracan	huracan
hurricane	hurricane
husky	husky
hut	hút,hụt
huu	hưu,hữu
huy	huy,húy,hủy
huych	huých,huỵch
huyen	huyên,huyền,huyễn,huyện
huyet	huyết,huyệt
huynh	huynh,huỳnh
huyt	huýt
hybrid	hybrid
hypermini	hypermini
hyundai	hyundai
i	i,ì,í,ỉ,ị,i
i10	i10
i20	i20
i30	i30
i40	i40
ia	ỉa
ich	ích,ịch
icon	icon
idea	idea
ideo	ideo
ignis	ignis
ii	ii
iii	iii
ikon	ikon
iltis	iltis
ilx	ilx
im	im,ỉm
imaj	imaj
impala	impala
imperial	imperial
impian	impian
impreza	impreza
impulse	impulse
in	in,ìn,ín,ỉn,in
indica	indica
indigo	indigo
indy	indy
infiniti	infiniti
inh	inh,ình,ĩnh
innova	innova
insight	insight
insignia	insignia
inspire	inspire
integra	integra
interstar	interstar
intimidator	intimidator
intrepid	intrepid
ipsum	ipsum
iq	iq
is	is
is300	is300
is300c	is300c
isetta	isetta
isuzu	isuzu
it	ít,ịt
italia	italia
iu	iu,ỉu
iv	iv
ix	ix
ix20	ix20
ix35	ix35
j	j
jac	jac
jaguar	jaguar
java	java
jazz	jazz
jeep	jeep
jeepster	jeepster
jet	jet
jetta	jetta
jimmy	jimmy
jimny	jimny
jinbei	jinbei
jmc	jmc
jmh	jmh
jo	jo
joice	joice
journey	journey
joylong	joylong
joyster	joyster
juara	juara
juke	juke
junior	junior
just	just
justy	justy
k	k
k10	k10
k2500	k2500
k2700	k2700
k3	k3
ka	ka
kadett	kadett
kahuna	kahuna
kalos	kalos
kamal	kamal
kapitan	kapitan
karisma	karisma
karmann	karmann
kb	kb
kc2700	kc2700
kcv	kcv
ke	ke,kè,ké,kê,kẹ,kẻ,kẽ,kế,kề,kể,kệ
kec	kéc
kech	kếch,kệch
kem	kem,kèm,kém,kẽm,kềm
ken	ken,kèn,kén,kên,kẹn,kền
keng	keng,kẻng
kenh	kênh,kềnh,kễnh,kệnh
kensington	kensington
keo	keo,kèo,kéo,kẹo,kẻo,kẽo
kep	kép,kẹp,kếp
ket	két,kẹt,kết
keu	kêu,kếu,kều
kha	kha,khà,khá,khả
khac	khác,khạc,khấc,khắc,khặc
khach	khách
khai	khai,khái,khải
kham	kham,khám,khâm,khăm,khảm,khấm,khắm,khẳm,khặm
khan	khan,khàn,khán,khân,khăn,khản,khấn,khẩn,khắn,khằn,khẳn
khang	khang,khàng,kháng,khăng,khạng,khảng,khắng,khằng,khẳng
khanh	khanh,khánh,khảnh
khao	khao,kháo,khạo,khảo
khap	kháp,khạp,khấp,khập,khắp
khat	khất,khật,khắt
khau	khau,kháu,khâu,khấu,khẩu
khay	khay,kháy,khảy,khẩy
khe	khe,khè,khé,khê,khẻ,khẽ,khế,khề,khệ
khec	khẹc
khem	khem
khen	khen,khèn,khén
khenh	khênh,khềnh,khểnh,khễnh,khệnh
kheo	kheo,khéo
khep	khép
khet	khét
kheu	khêu,khều
khi	khi,khì,khí,khỉ
khia	khía,khịa
khich	khích
khiem	khiêm,khiếm
khien	khiên,khiến,khiền,khiển
khieng	khiêng,khiễng,khiệng
khiep	khiếp
khiet	khiết
khieu	khiêu,khiếu
khin	khin,khìn
khinh	khinh,khỉnh
khit	khít,khịt
khiu	khiu,khíu
kho	kho,khò,khó,khô,khơ,khỏ,khố,khổ,khớ,khờ
khoa	khoa,khóa,khỏa
khoac	khoác
khoai	khoai,khoái,khoải
khoam	khoằm
khoan	khoan,khoán,khoăn,khoản,khoắn
khoang	khoang,khoáng,khoảng,khoắng
khoanh	khoanh,khoảnh
khoat	khoát,khoắt
khoay	khoáy
khoc	khóc,khốc
khoe	khoe,khóe,khỏe
khoen	khoen
khoeo	khoeo,khoèo,khoẻo
khoet	khoét
khoi	khoi,khói,khôi,khơi,khỏi,khối,khới,khởi
khom	khom,khòm,khóm,khọm
khon	khôn,khốn
khong	khòng,không,khỏng,khống,khổng
khop	khớp
khu	khu,khù,khú,khư,khụ,khủ,khứ,khừ,khử
khua	khua,khứa
khuan	khuân,khuẩn
khuang	khuâng
khuat	khuất
khuay	khuây,khuấy
khuc	khúc,khục
khue	khuê
khuech	khuếch
khui	khui
khum	khum,khúm
khung	khung,khùng,khúng,khụng,khủng,khứng,khừng,khựng
khuo	khuơ
khuoc	khước
khuoi	khươi
khuon	khuôn,khươn
khuong	khuông,khưởng,khưỡng
khuot	khướt,khượt
khuou	khướu
khut	khụt
khuu	khứu
khuy	khuy,khụy
khuya	khuya
khuyen	khuyên,khuyến,khuyển
khuyet	khuyết
khuynh	khuynh,khuỳnh,khuỷnh
khuyp	khuýp
khuyu	khuỵu,khuỷu
ki	ki,kì,kí,kĩ,kỉ,kị
kia	kia,kìa,kia
kich	kích,kịch
kiem	kiêm,kiếm,kiềm,kiểm,kiệm
kien	kiên,kiến,kiền,kiện
kieng	kiêng,kiếng,kiềng,kiểng,kiễng
kiep	kiếp
kiet	kiết,kiệt
kieu	kiêu,kiếu,kiều,kiểu,kiệu
kim	kim,kìm
kin	kìn,kín
king	king
kinh	kinh,kình,kính,kỉnh
kip	kíp,kịp
kit	kít,kịt
kiu	kĩu
kizashi	kizashi
kodiak	kodiak
kombi	kombi
korando	korando
kraftfahrzeug	kraftfahrzeug
kremer	kremer
ks	ks
kuga	kuga
kusabi	kusabi
kyron	kyron
l	l
l200	l200
l3	l3
l300	l300
l7	l7
la	la,là,lá,lã,lạ,lả
lac	lác,lạc,lấc,lắc,lặc
lacetti	lacetti
lach	lách,lạch
lafesta	lafesta
lagonda	lagonda
lagreat	lagreat
lai	lai,lài,lái,lãi,lại,lải
lam	lam,làm,lâm,lãm,lăm,lạm,lảm,lấm,lầm,lẩm,lẫm,lắm,lằm,lẳm,lặm
lamborghini	lamborghini
lan	lan,làn,lán,lân,lãn,lăn,lạn,lấn,lần,lẩn,lẫn,lận,lằn,lặn
lancer	lancer
land	land
lander	lander
lane	lane
lang	lang,làng,láng,lâng,lãng,lăng,lạng,lảng,lắng,lằng,lẳng,lẵng,lặng
lanh	lanh,lành,lánh,lãnh,lạnh,lảnh
lanos	lanos
lantis	lantis
lantra	lantra
lao	lao,lào,láo,lão,lạo,lảo
lap	láp,lạp,lấp,lập,lắp,lặp
lapin	lapin
laputa	laputa
laser	laser
lat	lát,lạt,lất,lật,lắt,lặt
lau	lau,làu,láu,lâu,lạu,lảu,lầu,lẩu,lậu
laurel	laurel
lay	lay,láy,lây,lạy,lảy,lấy,lầy,lẩy,lẫy,lậy
lcv	lcv
le	le,lè,lé,lê,lẹ,lẻ,lẽ,lề,lể,lễ,lệ,le
leaf	leaf
lec	léc
lech	lếch,lệch
leeza	leeza
legacy	legacy
leganza	leganza
legend	legend
legram	legram
lem	lem,lèm,lém,lẹm,lẻm
len	len,lèn,lén,lên,lẹn,lẻn,lẽn
leng	leng,léng,lẻng
lenh	lênh,lềnh,lệnh
leo	leo,lèo,léo,lẹo,lẻo,lẽo
leone	leone
leopard	leopard
lep	lép,lẹp
let	lét,lẹt,lết,lệt
leu	lêu,lếu,lều,lểu
levante	levante
levorg	levorg
lexcen	lexcen
lexus	lexus
lf	lf
lfa	lfa
lhs	lhs
li	li,lì,lí,lĩ,lị,li
lia	lia,lìa,lịa
liana	liana
liberty	liberty
lich	lích,lịch
liec	liếc
liem	liêm,liếm,liềm,liễm,liệm
lien	liên,liến,liền,liễn
lieng	liêng,liếng,liểng,liệng
liep	liếp,liệp
liet	liệt
lieu	liêu,liều,liễu,liệu
lifan	lifan
life	life
lim	lim,lìm,lịm
limousine	limousine
lin	lin
lincoln	lincoln
line	line
linea	linea
liner	liner
linh	linh,lình,lính,lỉnh,lịnh
lip	líp
lit	lít
lite	lite
litre	litre
liu	liu,lìu,líu,lỉu,lịu
livina	livina
lj	lj
lm	lm
lmp	lmp
lmr	lmr
ln7	ln7
lo	lo,lò,ló,lô,lõ,lơ,lọ,lố,lồ,lổ,lỗ,lộ,lớ,lờ,lở,lỡ,lợ
loa	loa,lòa,lóa,lõa,lỏa
loac	loạc
loadrunner	loadrunner
loai	loài,loại
loan	loan,loàn,loăn,loạn
loang	loang,loàng,loáng,loãng,loăng,loạng,loảng,loằng
loanh	loanh
loat	loát,loạt,loắt
loay	loay
loc	lóc,lọc,lốc,lộc
loe	loe,lòe,lóe
loen	loen
loet	loét,loẹt
logo	logo
loi	loi,lòi,lói,lôi,lõi,lơi,lọi,lỏi,lối,lồi,lỗi,lội,lới,lời,lởi,lỡi,lợi
lom	lom,lòm,lóm,lôm,lõm,lọm,lỏm,lốm,lồm,lổm,lộm,lờm,lởm,lỡm,lợm
lon	lon,lòn,lơn,lọn,lỏn,lốn,lồn,lổn,lộn,lớn,lờn,lởn,lợn
long	long,lòng,lóng,lông,lõng,lọng,lỏng,lồng,lổng,lộng,long
longue	longue
loong	loong
lop	lóp,lọp,lốp,lộp,lớp,lợp
lot	lót,lọt,lốt,lột,lớt,lợt
lotus	lotus
ls	ls
ls460l	ls460l
ls600h	ls600h
lt	lt
ltd	ltd
lu	lu,lù,lú,lũ,lư,lụ,lủ,lừ,lử,lữ,lự
lua	lua,lùa,lúa,lũa,lưa,lụa,lứa,lừa,lửa,lữa,lựa
luan	luân,luấn,luẩn,luận
luat	luật
luc	lúc,lục,lức,lực
luce	luce
lui	lui,lùi,lúi,lũi,lụi,lủi
lum	lum,lùm,lúm,lũm,lụm,lủm
lumina	lumina
lun	lùn,lún,lũn,lụn,lủn
lung	lung,lùng,lúng,lũng,lưng,lụng,lủng,lừng,lửng,lững,lựng
luoc	luốc,luộc,lược
luoi	lưới,lười,lưỡi
luom	luôm,luộm,lươm,lườm,lượm
luon	luôn,luồn,lươn,lườn,lượn
luong	luông,luống,luồng,luỗng,lương,lướng,lường,lưỡng,lượng
luot	luốt,lướt,lượt
lup	lúp,lụp
lupo	lupo
lut	lút,lụt,lứt
luu	lưu,lựu
luy	lúy,lũy,lụy
luya	luya
luych	luých
luyen	luyến,luyện
luyn	luyn
lx	lx
lynx	lynx
m	m
m1	m1
m12	m12
m2	m2
m20	m20
m3	m3
m4	m4
m5	m5
m6	m6
m80	m80
ma	ma,mà,má,mã,mạ,mả
mac	mác,mạc,mắc,mặc
macan	macan
mach	mách,mạch
maepsy	maepsy
magellan	magellan
magentis	magentis
magna	magna
magnett	magnett
magnum	magnum
magnus	magnus
mahindra	mahindra
mai	mai,mài,mái,mãi,mại,mải
majestic	majestic
malibu	malibu
mam	mám,mâm,măm,mầm,mẩm,mẫm,mậm,mắm
man	man,màn,mân,mãn,măn,mạn,mấn,mần,mẩn,mẫn,mận,mắn,mằn,mẳn,mặn
mang	mang,màng,máng,mãng,măng,mạng,mảng,mắng
manh	manh,mành,mánh,mãnh,mạnh,mảnh
mans	mans
manta	manta
manza	manza
mao	mao,mào,máo,mão,mạo
map	mạp,mấp,mập
maranello	maranello
marathon	marathon
marauder	marauder
marcia	marcia
marea	marea
mariner	mariner
mark	mark
marquis	marquis
martin	martin
maserati	maserati
master	master
mat	mát,mạt,mất,mật,mắt,mặt
materia	materia
matiz	matiz
matrix	matrix
mau	mau,màu,máu,mâu,mấu,mầu,mẩu,mẫu,mậu
maverick	maverick
max	max
maxima	maxima
maxx	maxx
may	may,mày,máy,mây,mạy,mảy,mấy,mầy,mẩy,mậy
mazda	mazda
mazdaspeed3	mazdaspeed3
mazdaspeed6	mazdaspeed6
mc4	mc4
mcc	mcc
mclaren	mclaren
mdx	mdx
me	me,mè,mé,mê,mẹ,mẻ,mẽ,mế,mề,mễ,mệ
mec	méc
mech	mếch
mega	mega
megastar	megastar
mem	mèm,mém,mềm
men	men,mèn,mén,mên,mến,mền
meng	meng
menh	mênh,mệnh
meo	meo,mèo,méo,mẹo
mep	mép,mẹp
mercedes	mercedes
mercury	mercury
meriva	meriva
met	mét,mẹt,mết,mệt
meteor	meteor
metro	metro
meu	mếu
mexico	mexico
mg	mg
mga	mga
mgb	mgb
mgc	mgc
mi	mi,mì,mí,mĩ,mỉ,mị,mi
mia	mia,mía,mỉa
miata	miata
mich	mích,mịch
micra	micra
microbus	microbus
micros	micros
mid4	mid4
midge	midge
midget	midget
mien	miên,miến,miền,miễn,miện
mieng	miếng,miệng
miet	miết,miệt
mieu	miêu,miếu,miều,miễu
miev	miev
miglia	miglia
milan	milan
mille	mille
millenia	millenia
millenium	millenium
mim	mím,mĩm,mỉm
min	min,mìn,mịn
minh	minh,mình
mini	mini
minica	minica
mint	mint
minx	minx
mip	míp
mira	mira
mirada	mirada
mirafiori	mirafiori
mirage	mirage
mit	mít,mịt
mito	mito
mitsubishi	mitsubishi
miu	míu
mk	mk
mks	mks
mkt	mkt
mkx	mkx
mkz	mkz
ml	ml
mm	mm
mo	mo,mò,mó,mô,mõ,mơ,mọ,mỏ,mố,mồ,mổ,mỗ,mộ,mớ,mờ,mở,mỡ,mợ
moay	moay
mobilio	mobilio
moc	móc,mọc,mốc,mộc
moco	moco
model	model
modena	modena
mohave	mohave
moi	moi,mòi,mói,môi,mọi,mỏi,mối,mồi,mỗi,mội,mới,mời
mom	mom,mòm,móm,môm,mõm,mỏm,mồm,mớm,mờm
mon	mon,mòn,món,môn,mơn,mọn,mồn,mớn,mởn
monaco	monaco
monarch	monarch
mondeo	mondeo
mondial	mondial
mong	mong,mòng,móng,mông,mọng,mỏng,mống,mồng,mổng,mộng
montclair	montclair
monte	monte
montego	montego
monterey	monterey
montero	montero
montrose	montrose
monza	monza
mooc	moóc
moong	moong
mop	móp,mọp
morgan	morgan
mot	mót,mọt,mốt,một
mountaineer	mountaineer
movano	movano
move	move
mpv	mpv
mpx	mpx
mr	mr
mr2	mr2
mrj	mrj
ms	ms
mu	mu,mù,mú,mũ,mụ,mủ,mu
mua	mua,mùa,múa,mưa,mứa,mửa,mựa
muc	múc,mục,mức,mực
mui	mui,mùi,múi,mũi,mụi,mủi
mulsanne	mulsanne
multi	multi
multicarry	multicarry
multipla	multipla
multivan	multivan
mum	múm,mũm,mủm,mum
mun	mun,mùn,mún,mụn,mủn
mung	mung,mùng,mưng,mủng,mừng,mửng
muoc	mược
muoi	muôi,muối,muồi,muỗi,muội,mươi,mười,mưởi
muom	muỗm
muon	muôn,muốn,muộn,mướn,mượn
muong	muông,muống,muồng,muỗng,mương,mường
muop	mướp
muot	muốt,mướt,mượt
muou	mưỡu
mup	múp
murano	murano
muse	muse
musiro	musiro
musso	musso
musson	musson
mustang	mustang
mut	mút,mụt,mứt
muu	mưu,mứu
mx	mx
mystique	mystique
mythos	mythos
mz40	mz40
mz45	mz45
na	na,nà,ná,nã,nạ,nả,na
nac	nác,nạc,nấc,nắc,nặc
nach	nách
nai	nai,nài,nái,nại,nải
naked	naked
nam	nam,nám,năm,nạm,nấm,nầm,nậm,nắm,nằm
nan	nan,nàn,nán,năn,nạn,nản,nấn,nần,nẫn,nắn,nặn
nang	nang,nàng,náng,nâng,năng,nạng,nấng,nẫng,nậng,nắng,nằng,nặng
nanh	nanh,nành,nánh,nạnh
nano	nano
nao	nao,nào,náo,não,nạo,nảo
nap	náp,nạp,nấp,nập,nắp
nat	nát,nạt
nau	náu,nâu,nấu,nẫu,nậu
navajo	navajo
navara	navara
navigator	navigator
nay	nay,này,náy,nây,nãy,nạy,nảy,nấy,nầy,nẩy,nẫy,nậy
nc	nc
ne	ne,nè,né,nê,nẹ,nẻ,nề,nể,nệ
neighbor	neighbor
nem	nem,ném,nêm,nếm,nệm
nen	nen,nén,nên,nến,nền,nện
nenh	nênh
neo	neo,nèo,néo,nẻo
neon	neon
neos	neos
nep	nép,nẹp,nếp
nessie	nessie
net	nét,nẹt,nết
neu	nêu,nếu
new	new
newport	newport
nexia	nexia
nga	nga,ngà,ngã,ngả
ngac	ngác,ngạc,ngấc,ngắc
ngach	ngách,ngạch
ngai	ngai,ngài,ngái,ngãi,ngại,ngải
ngam	ngàm,ngâm,ngăm,ngấm,ngầm,ngẩm,ngẫm,ngậm,ngắm
ngan	ngan,ngàn,ngán,ngân,ngăn,ngạn,ngấn,ngần,ngẩn,ngắn,ngằn
ngang	ngang,ngàng,ngáng,ngãng,ngẩng,ngẳng,ngẵng
nganh	ngành,ngạnh,ngảnh
ngao	ngao,ngào,ngáo,ngão,ngạo
ngap	ngáp,ngấp,ngập
ngat	ngát,ngạt,ngất,ngật,ngắt,ngặt
ngau	ngau,ngàu,ngáu,ngâu,ngấu,ngầu,ngẫu,ngậu
ngay	ngay,ngày,ngáy,ngây,ngấy,ngầy,ngậy
nghe	nghe,nghè,nghé,nghê,nghẹ,nghề,nghể,nghễ,nghệ
nghech	nghếch,nghệch
nghen	nghen,nghèn,nghén,nghẹn,nghẽn,nghển,nghện
nghenh	nghênh,nghểnh,nghễnh
ngheo	nghèo,nghẹo,nghẻo,nghẽo
nghet	nghét,nghẹt
ngheu	nghêu,nghều,nghểu,nghễu,nghệu
nghi	nghi,nghì,nghí,nghĩ,nghỉ,nghị
nghia	nghía,nghĩa
nghich	nghịch
nghiem	nghiêm,nghiễm,nghiệm
nghien	nghiên,nghiến,nghiền,nghiện
nghieng	nghiêng
nghiep	nghiệp
nghiet	nghiệt
nghim	nghỉm
nghin	nghìn
nghinh	nghinh,nghĩnh,nghỉnh
nghit	nghịt
nghiu	nghiu,nghỉu,nghịu
nghuech	nghuếch
ngo	ngo,ngò,ngó,ngô,ngõ,ngơ,ngọ,ngỏ,ngố,ngồ,ngổ,ngỗ,ngộ,ngớ,ngờ,ngỡ,ngợ
ngoa	ngoa,ngõa
ngoac	ngoác,ngoạc,ngoắc,ngoặc
ngoai	ngoai,ngoài,ngoái,ngoại,ngoải
ngoam	ngọam
ngoan	ngoan,ngoãn,ngoạn,ngoằn
ngoang	ngoằng,ngoẵng
ngoanh	ngoảnh
ngoao	ngoao,ngóao
ngoap	ngoáp
ngoat	ngoắt,ngoặt
ngoay	ngoay,ngoáy,ngoạy,ngoảy
ngoc	ngóc,ngọc,ngốc,ngộc
ngoe	ngoe,ngóe
ngoen	ngoen,ngoẻn
ngoeo	ngoèo,ngoéo,ngoẹo,ngoẻo
ngoet	ngoét
ngoi	ngoi,ngòi,ngói,ngôi,ngơi,ngồi,ngời,ngợi
ngom	ngòm,ngóm,ngơm,ngỏm,ngổm,ngờm,ngợm
ngon	ngon,ngón,ngôn,ngọn,ngỏn,ngốn,ngồn,ngổn,ngộn,ngớn
ngong	ngòng,ngóng,ngông,ngõng,ngọng,ngỏng,ngồng,ngỗng
ngop	ngóp,ngớp,ngợp
ngot	ngót,ngọt,ngốt,ngột,ngớt
ngu	ngu,ngù,ngũ,ngư,ngụ,ngủ,ngứ,ngừ,ngữ,ngự
ngua	ngưa,ngụa,ngứa,ngừa,ngửa,ngựa
nguay	nguây,nguẩy,nguậy
nguc	ngúc,ngục,ngực
nguech	nguệch
ngui	ngùi,ngủi,ngửi
ngum	ngụm,ngủm
ngun	ngùn,ngún,ngủn
ngung	ngùng,ngúng,ngưng,ngủng,ngừng,ngửng
nguoc	ngước,ngược
nguoi	nguôi,nguội,ngươi,người
nguon	nguồn
nguong	ngường,ngưởng,ngưỡng,ngượng
ngup	ngụp
ngut	ngút,ngụt,ngứt
nguu	ngưu
nguy	nguy,ngụy
nguyen	nguyên,nguyền,nguyện
nguyet	nguyệt
nguyt	nguýt
nguyu	nguỷu
nha	nha,nhà,nhá,nhã,nhả
nhac	nhác,nhạc,nhấc,nhắc
nhach	nhách
nhai	nhai,nhài,nhái,nhãi,nhại,nhải
nham	nham,nhàm,nhám,nhâm,nhăm,nhảm,nhấm,nhầm,nhẩm,nhậm,nhắm,nhằm,nhặm
nhan	nhan,nhàn,nhân,nhãn,nhăn,nhạn,nhản,nhấn,nhần,nhẩn,nhẫn,nhận,nhắn,nhằn,nhẳn,nhẵn,nhặn
nhang	nhang,nhàng,nhâng,nhãng,nhăng,nhạng,nhắng,nhằng,nhẳng,nhẵng,nhặng
nhanh	nhanh,nhành,nhánh,nhạnh,nhảnh
nhao	nhao,nhào,nháo,nhão,nhạo,nhảo
nhap	nháp,nhạp,nhấp,nhập,nhắp
nhat	nhát,nhạt,nhất,nhật,nhắt,nhặt
nhau	nhau,nhàu,nhâu,nhảu,nhầu,nhẩu,nhậu
nhay	nhay,nháy,nhây,nhạy,nhảy,nhầy,nhẩy,nhẫy,nhậy
nhe	nhe,nhè,nhé,nhẹ,nhẻ,nhẽ,nhể,nhễ
nhech	nhếch,nhệch
nhem	nhem,nhèm,nhẹm,nhẻm
nhen	nhen,nhén,nhẹn,nhện
nhenh	nhênh
nheo	nheo,nhèo,nhéo,nhẹo,nhẽo
nhep	nhép,nhẹp
nhet	nhét,nhẹt
nheu	nhếu,nhểu
nhi	nhi,nhì,nhí,nhĩ,nhỉ,nhị
nhia	nhía
nhich	nhích
nhiec	nhiếc
nhiem	nhiễm,nhiệm
nhien	nhiên,nhiễn
nhiep	nhiếp
nhiet	nhiệt
nhieu	nhiêu,nhiều,nhiễu
nhim	nhím
nhin	nhìn,nhín,nhịn
nhinh	nhinh,nhính,nhỉnh
nhip	nhíp,nhịp
nhit	nhít,nhịt
nhiu	nhíu,nhỉu,nhịu
nho	nho,nhó,nhô,nhơ,nhọ,nhỏ,nhố,nhổ,nhớ,nhờ,nhở,nhỡ,nhợ
nhoa	nhòa
nhoai	nhoai,nhoài
nhoam	nhòam
nhoang	nhoáng,nhoạng
nhoay	nhoay,nhoáy
nhoc	nhóc,nhọc,nhốc
nhoe	nhoe,nhòe
nhoen	nhoen,nhoèn,nhoẻn
nhoet	nhoét,nhoẹt
nhoi	nhoi,nhói,nhôi,nhơi,nhối,nhồi,nhội,nhời,nhởi
nhom	nhom,nhòm,nhóm,nhôm,nhõm,nhơm,nhỏm,nhồm,nhổm,nhớm,nhờm
nhon	nhon,nhón,nhôn,nhơn,nhọn,nhốn,nhồn,nhổn,nhộn,nhớn,nhờn,nhởn,nhỡn
nhong	nhong,nhòng,nhóng,nhông,nhõng,nhỏng,nhồng,nhộng
nhop	nhóp,nhớp
nhot	nhót,nhọt,nhốt,nhột,nhớt,nhợt
nhr	nhr
nhrpv	nhrpv
nhu	nhu,nhú,nhũ,như,nhụ,nhủ,nhứ,nhừ,nhử,nhự
nhua	nhúa,nhụa,nhựa
nhuan	nhuần,nhuận
nhuc	nhúc,nhục,nhức
nhue	nhuệ
nhui	nhùi,nhúi,nhụi,nhủi
nhum	nhum,nhúm
nhun	nhún,nhũn,nhủn
nhung	nhung,nhùng,nhúng,nhũng,nhưng,nhụng,nhủng,những
nhuoc	nhuốc,nhược
nhuom	nhuôm,nhuốm,nhuộm
nhuon	nhướn
nhuong	nhương,nhướng,nhường,nhưỡng,nhượng
nhut	nhút,nhụt,nhứt,nhựt
nhuy	nhụy
nhuyen	nhuyễn
ni	ni,nì,nỉ
nia	nia,nĩa
nich	ních,nịch
niem	niêm,niềm,niệm
nien	niên
nieng	niềng,niễng
niet	niết,niệt
nieu	niêu,niệu
nin	nin,nín
ninh	ninh,nính,nịnh
nip	níp
nissan	nissan
nit	nít,nịt
nitro	nitro
niu	niu,níu,nịu
no	no,nò,nó,nô,nõ,nơ,nọ,nỏ,nổ,nỗ,nộ,nớ,nở,nỡ,nợ,no
noan	noãn
noc	nóc,nọc,nốc
noi	noi,nòi,nói,nôi,nơi,nối,nồi,nổi,nỗi,nội,nới
nom	nom,nòm,nôm,nơm,nỏm,nồm,nộm,nờm,nỡm
nomad	nomad
non	non,nón,nôn,nõn,nọn,nộn
nong	nong,nòng,nóng,nông,nọng,nống,nồng,nổng,nỗng
nop	nóp,nộp,nớp,nợp
not	nót,nọt,nốt,nột,nớt
note	note
nova	nova
np300	np300
nsx	nsx
nu	nu,nư,nụ,nữ,nự
nua	nua,nưa,nủa,nứa,nửa,nữa
nubira	nubira
nuc	núc,nục,nức,nực
nui	nùi,núi
num	núm
nun	nùn
nung	nung,nùng,núng,nũng,nựng
nuoc	nuộc,nước
nuoi	nuôi,nuối
nuom	nuốm,nườm
nuong	nuông,nương,nướng,nường
nuop	nượp
nuot	nuốt,nuột
nup	núp
nut	nút,nứt
nuvola	nuvola
nuvolari	nuvolari
nv	nv
nv350	nv350
nx	nx
o	o,ó,ô,ơ,ọ,ố,ồ,ổ,ớ,ờ,ở,ợ
o21	o21
oa	oa,òa
oach	oách,oạch
oai	oai,oài,oái,oại,oải
oam	oăm
oan	oan,oán,oản,oằn
oang	oang,oàng,oẳng
oanh	oanh,oành
oap	oạp
oat	oát,oắt,oặt
oc	óc,ọc,ốc,ộc
odyssey	odyssey
oe	oe,óe,ọe,ỏe
oi	oi,òi,ói,ôi,ơi,ỏi,ối,ổi,ới
olympia	olympia
om	om,ôm,ỏm,ốm,ồm,ớm,ỡm
omega	omega
omni	omni
on	ôn,ơn,ỏn,ồn,ổn,ớn
one	one
ong	ong,òng,óng,ông,õng,ỏng,ống,ồng,ổng
op	óp,ọp,ốp,ộp
opa	opa
opel	opel
opirus	opirus
opti	opti
optima	optima
optra	optra
orion	orion
orlando	orlando
ot	ót,ốt,ớt,ợt,ot
oting	oting
outback	outback
outlander	outlander
p	p
p2	p2
p5	p5
pa	pa
paceman	paceman
pacifica	pacifica
pajero	pajero
palio	palio
pan	pan,pan
panamera	panamera
panda	panda
panel	panel
panh	panh
parati	parati
park	park
paseo	paseo
passat	passat
passport	passport
pathfinder	pathfinder
patriot	patriot
patrol	patrol
pc	pc
pe	pê
peak	peak
perdana	perdana
peri	peri
persona	persona
peugeot	peugeot
pha	pha,phà,phá,phả
phac	phác,phạc,phắc
phach	phách,phạch
phaeton	phaeton
phai	phai,phái,phải
pham	phàm,phăm,phạm,phầm,phẩm
phan	phàn,phán,phân,phăn,phạn,phản,phấn,phần,phẫn,phận
phang	phang,phàng,phăng,phảng,phẳng
phanh	phanh,phành
phantom	phantom
phao	phao,phào,pháo
phap	pháp,phấp,phập,phắp
phat	phát,phạt,phất,phật,phắt
phau	phau,phẫu
phay	phay,phây,phảy,phẩy
phe	phe,phè,phê,phế,phề,phệ
phec	phéc
phech	phếch
phen	phen,phèn,phên
pheng	phèng,phéng
phenh	phệnh
pheo	pheo,phèo
phep	phép
phet	phét,phết,phệt
pheu	phếu,phều,phễu
phi	phi,phì,phí,phỉ,phị
phia	phìa,phía,phịa
phich	phích,phịch
phiem	phiếm
phien	phiên,phiến,phiền,phiện
phiet	phiết,phiệt
phieu	phiêu,phiếu,phiệu
phim	phim,phím
phin	phin
phinh	phinh,phình,phính,phĩnh,phỉnh
phiu	phiu,phịu
pho	pho,phò,phó,phô,phơ,phố,phổ,phờ,phở
phoc	phóc,phốc
phoenix	phoenix
phoi	phoi,phòi,phôi,phơi,phối,phổi,phới
phom	phôm
phon	phôn,phơn,phồn,phớn,phởn,phỡn
phong	phong,phòng,phóng,phông,phỏng,phồng,phổng,phỗng,phộng
phooc	phoóc
phop	phốp
phot	phót,phọt,phớt
phu	phu,phù,phú,phũ,phụ,phủ
phua	phua,phứa,phựa
phuc	phúc,phục,phức
phui	phui,phủi
phun	phun,phùn,phún
phung	phung,phùng,phúng,phưng,phụng,phừng
phuoc	phước
phuon	phướn,phưỡn
phuong	phương,phướng,phường,phượng
phut	phút,phụt,phứt
phuy	phuy
pi	pi
piazza	piazza
picanto	picanto
pickster	pickster
picnic	picnic
pikes	pikes
pilot	pilot
pinin	pinin
pintara	pintara
pit	pít
pixo	pixo
plas	plas
platina	platina
pleo	pleo
plug	plug
plus	plus
po	pô
pod	pod
polara	polara
polo	polo
pom	pom
ponton	ponton
pony	pony
popular	popular
porsche	porsche
porter	porter
portico	portico
potentia	potentia
power	power
prado	prado
prairie	prairie
prefect	prefect
pregio	pregio
prelude	prelude
premacy	premacy
premiere	premiere
presea	presea
president	president
previa	previa
pride	pride
primera	primera
prince	prince
princess	princess
prius	prius
prizm	prizm
pro	pro
probe	probe
progress	progress
protege	protege
proteo	proteo
proton	proton
proudia	proudia
prowler	prowler
pt	pt
pu	pu
pua	pụa
publica	publica
pulsar	pulsar
puma	puma
punto	punto
puoc	puốc
pv	pv
q21	q21
q22	q22
q22b	q22b
q22l	q22l
q3	q3
q5	q5
q7	q7
qashqai	qashqai
qin	qin
qq	qq
qq3	qq3
qua	qua,quà,quá,quạ,quả
quac	quác,quạc,quấc,quắc,quặc
quach	quách,quạch
quadri	quadri
quai	quai,quài,quái,quại,quải
quam	quăm,quắm,quằm,quặm
quan	quan,quàn,quán,quân,quăn,quản,quấn,quần,quẩn,quẫn,quận,quắn,quằn,quặn
quang	quang,quàng,quáng,quãng,quăng,quạng,quảng,quầng,quẩng,quẳng,quặng
quanh	quanh,quành,quánh,quạnh
quantum	quantum
quao	quào,quáo
quap	quắp,quặp
quat	quát,quạt,quất,quật,quắt,quặt
quattro	quattro
quattroporte	quattroporte
quau	quàu,quạu
quay	quay,quày,quây,quạy,quảy,quấy,quầy,quẩy,quẫy,quậy
que	que,què,qué,quê,quẻ,quẽ,quế,quệ
quech	quệch
quen	quen,quèn,quén,quên,quện
queo	queo,quèo,quéo,quẹo
quest	quest
quet	quét,quẹt,quết,quệt
queu	quều
quintet	quintet
quo	quơ,quớ,quờ,quở
quoc	quốc
quy	quy,quý,quỳ,quỵ,quỷ,quỹ
quych	quých
quyen	quyên,quyến,quyền,quyển,quyện
quyet	quyết,quyệt
quynh	quýnh,quỳnh,quỷnh
quyp	quỵp
quyt	quýt,quỵt
quyu	quýu
r	r
r2	r2
r4	r4
r8	r8
r8r	r8r
ra	ra,rà,rá,rã,rạ,rả
rabbit	rabbit
rac	rác,rạc,rắc,rặc
rach	rách,rạch
ractis	ractis
rai	rai,rài,rái,rãi,rải
raider	raider
ram	ram,rám,râm,răm,rạm,rấm,rầm,rẩm,rẫm,rậm,rắm,rằm,rặm,ram
ran	ran,ràn,rán,rân,răn,rạn,rấn,rần,rận,rắn,rằn,rẳn,rặn
ranchero	ranchero
rang	rang,ràng,ráng,răng,rạng,rảng,rằng,rặng
range	range
ranger	ranger
ranh	ranh,rành,rãnh,rảnh
rao	rao,rào,ráo,rão,rạo,rảo
rap	ráp,rạp,rấp,rập,rắp
rapide	rapide
rasheen	rasheen
rat	rát,rạt,rất,rật,rắt,rặt
rau	rau,ráu,râu,rảu,rầu
rav4	rav4
ray	ray,rày,ráy,rây,rãy,rạy,rảy,rầy,rẩy,rẫy
razor	razor
rc	rc
rcz	rcz
rdx	rdx
re	re,rè,ré,rê,rẻ,rẽ,rế,rề,rể,rễ,rệ
rech	rếch,rệch
refine	refine
regata	regata
rein	rein
rekord	rekord
relsamo	relsamo
rem	rèm,rêm
ren	ren,rèn,rén,rên,rến,rền,rện
reng	rẻng
renh	rềnh
rennsportwagen	rennsportwagen
reno	reno
reo	reo,réo,rẻo
rep	rệp
ret	rét,rết,rệt
retona	retona
retro	retro
reu	rêu,rều,rệu
revo	revo
rex	rex
rexton	rexton
rezzo	rezzo
rgt	rgt
rhino	rhino
ri	ri,rì,rí,rĩ,rỉ,rị
ria	ria,rìa,rỉa,rịa
rich	rích,rịch,rich
ridgeline	ridgeline
riem	riềm
rien	riên
rieng	riêng
riet	riết,riệt
rieu	riêu,riếu,riễu
rim	rim
rin	rin,rĩn,rịn
rinh	rinh,rình,rỉnh
rio	rio
rip	rịp
rit	rít,rịt
ritmo	ritmo
riu	riu,rìu,ríu
rl	rl
rlx	rlx
ro	ro,rò,ró,rô,rõ,rơ,rọ,rỏ,rồ,rổ,rỗ,rộ,rớ,rờ,rở,rỡ,rợ
roa	roa
roadster	roadster
roc	róc,rọc,rốc,rộc
rocky	rocky
rodeo	rodeo
rodius	rodius
rogue	rogue
roi	roi,ròi,rói,rõi,rơi,rọi,rỏi,rối,rồi,rỗi,rời,rợi
rolls	rolls
rom	róm,rôm,rơm,rỏm,rộm,rớm,rờm,rởm
romeo	romeo
ron	ròn,rón,rơn,rỏn,rốn,rổn,rộn,rờn,rởn,rỡn,rợn
rondo	rondo
rong	rong,ròng,róng,rông,rống,rồng,rỗng,rộng
rop	rộp,rớp,rợp
rosemeyer	rosemeyer
rossa	rossa
rot	rót,rọt,rốt,rớt
routan	routan
rover	rover
royale	royale
royce	royce
rpm	rpm
rr	rr
rs	rs
rs2	rs2
rs3	rs3
rs4	rs4
rs6	rs6
rsc	rsc
rsx	rsx
ru	ru,rù,rú,rũ,rủ
rua	rua,rùa,rũa,rưa,rụa,rủa,rứa,rửa,rữa,rựa
rubicon	rubicon
ruc	rúc,rục,rức,rực
rui	rui,rụi,rủi
rum	rum,rùm,rúm,rụm
run	run,rùn,rún,rủn
rung	rung,rùng,rúng,rưng,rụng,rủng,rừng
runner	runner
runx	runx
ruoc	ruốc,rước
ruoi	ruối,ruồi,ruổi,rươi,rưới,rười,rưởi,rưỡi,rượi
ruom	ruộm,rướm,rườm
ruon	ruôn,rướn,rượn
ruong	ruồng,ruỗng,ruộng,rương,rường
ruot	ruốt,ruột,rượt
ruou	rượu
rup	rúp
rustler	rustler
rut	rút,rụt,rứt
rv8	rv8
rvr	rvr
rx	rx
rz	rz
s	s
s1	s1
s2	s2
s2000	s2000
s3	s3
s30	s30
s4	s4
s40	s40
s5	s5
s500	s500
s6	s6
s60	s60
s600	s600
s7	s7
s70	s70
s8	s8
s80	s80
s800	s800
s90	s90
sa	sa,sà,sá,sã,sạ,sả
saab	saab
saber	saber
sabia	sabia
sable	sable
sac	sác,sắc,sặc
sach	sách,sạch
saetta	saetta
safari	safari
sai	sai,sài,sái,sãi,sải
sail	sail
saloon	saloon
sam	sam,sàm,sám,sâm,săm,sạm,sấm,sầm,sẩm,sẫm,sậm,sắm,sặm
samurai	samurai
san	san,sàn,sán,sân,săn,sạn,sản,sấn,sần,sẩn,sắn,sẵn
sang	sang,sàng,sáng,săng,sảng,sắng,sằng
sanh	sanh,sành,sánh,sảnh
santa	santa
santana	santana
sao	sao,sào,sáo,sạo,sảo
sap	sáp,sạp,sấp,sập,sắp
sapporo	sapporo
sat	sát,sạt,sất,sắt,sặt
satellite	satellite
satria	satria
sau	sau,sáu,sâu,sấu,sầu,sậu
savana	savana
savvy	savvy
say	say,sây,sảy,sấy,sầy,sẩy,sậy
sc	sc
scaglietti	scaglietti
scarabeo	scarabeo
scc	scc
schwimmwagen	schwimmwagen
scighera	scighera
scion	scion
scirocco	scirocco
scorpio	scorpio
scoupe	scoupe
scudo	scudo
se	se,sè,sê,sẹ,sẻ,sẽ,sề,sể,sệ
sea	sea
sebring	sebring
sec	séc
sedici	sedici
sedona	sedona
seicento	seicento
sem	sém
sen	sen,sên,sẻn,sến,sền
senator	senator
senh	sênh,sểnh
sentia	sentia
sentinel	sentinel
sentra	sentra
seo	seo,sèo,sẹo
sep	sếp
sephia	sephia
sequoia	sequoia
sera	sera
serena	serena
set	sét,sệt
seu	sêu,sếu,sều
seville	seville
shadow	shadow
sharan	sharan
shelby	shelby
shogun	shogun
shuma	shuma
shuttle	shuttle
si	si,sì,sĩ,sỉ,sị
sia	sỉa,sịa
sidekick	sidekick
sidewinder	sidewinder
siec	siếc
siem	siểm
siena	siena
sieng	siêng
sienna	sienna
sierra	sierra
siet	siết
sieu	siêu
sigma	sigma
signum	signum
silverado	silverado
silvia	silvia
sim	sim
sin	sin
single	single
sinh	sinh,sình,sính
sirion	sirion
sit	sít,sịt
sixteen	sixteen
sixty	sixty
sj	sj
skyline	skyline
skyliner	skyliner
sl	sl
slk	slk
slr	slr
sls	sls
slx	slx
so	so,sò,sô,sơ,sọ,sỏ,số,sồ,sổ,sỗ,sộ,sớ,sờ,sở,sỡ,sợ
soa	soa
soai	soài,soái,soải
soan	soàn,soán,soạn
soang	soạng,soảng
soarer	soarer
soat	soát,soạt
soc	sóc,sọc,sốc
soi	soi,sòi,sói,sôi,sõi,sỏi,sồi,sổi,sới,sởi,sợi
sol	sol
solara	solara
solitaire	solitaire
som	sòm,sơm,sọm,sớm,sờm
son	son,sòn,són,sơn,sồn,sớn,sờn,sởn
sonata	sonata
song	song,sòng,sóng,sông,sõng,sống,sồng,sổng
sonic	sonic
sonoma	sonoma
sooc	soóc
soong	soong
sop	sốp,sộp
sorento	sorento
sot	sót,sọt,sốt,sột,sớt
soul	soul
sovereign	sovereign
sp	sp
sp2	sp2
space	space
spacegear	spacegear
spacio	spacio
spark	spark
sparky	sparky
speciale	speciale
spectra	spectra
spectra5	spectra5
speed	speed
speedster	speedster
spiano	spiano
spider	spider
spin	spin
spirit	spirit
splash	splash
sport	sport
sportage	sportage
sportback	sportback
sportiva	sportiva
sportivo	sportivo
sportut	sportut
sportwagen	sportwagen
sprint	sprint
sprinter	sprinter
spur	spur
spyder	spyder
sq5	sq5
squareback	squareback
srt	srt
srx	srx
ss	ss
ssangyong	ssangyong
ssm	ssm
ssr	ssr
ssu	ssu
st	st
stagea	stagea
stallion	stallion
stanza	stanza
star	star
starda	starda
starex	starex
starion	starion
starlet	starlet
starlight	starlight
state	state
station	station
stavic	stavic
stealth	stealth
stellar	stellar
step	step
steppenwolf	steppenwolf
sti	sti
stilo	stilo
stingray	stingray
strada	strada
stratus	stratus
stream	stream
sts	sts
stylus	stylus
su	su,sù,sú,sư,sụ,sứ,sử,sự
sua	sưa,sụa,sủa,sứa,sửa,sữa
suat	suất
subaru	subaru
suburban	suburban
suc	súc,sục,sức,sực
succe	succe
sue	suê
sui	sui,sùi,sủi
sum	sum,sùm,sụm
sumo	sumo
sun	sun,sún,sụn
sung	sung,sùng,súng,sũng,sưng,sủng,sừng,sửng,sững,sựng
sunny	sunny
sunray	sunray
suoi	suối,sưởi
suon	suôn,sườn
suong	suông,suồng,sương,sướng,sượng
suot	suốt,sướt,sượt
sup	súp,sụp,sup
super	super
superamerica	superamerica
superfast	superfast
supersports	supersports
supra	supra
suri	suri
sut	sút,sụt,sứt,sut
suu	sưu,sửu
suw	suw
suy	suy,súy
suyen	suyển,suyễn
suyt	suýt,suỵt
suzuki	suzuki
svx	svx
sw	sw
swift	swift
sx	sx
sx4	sx4
sylphy	sylphy
synergy	synergy
sz	sz
t	t
t2	t2
t2b	t2b
t4100	t4100
ta	ta,tà,tá,tã,tạ,tả
tac	tác,tạc,tấc,tắc,tặc
tach	tách,tạch
tacoma	tacoma
tacuma	tacuma
taft	taft
tahoe	tahoe
tai	tai,tài,tái,tãi,tại,tải
tam	tam,tàm,tám,tâm,tăm,tạm,tấm,tầm,tẩm,tậm,tắm,tằm
tan	tan,tàn,tán,tân,tăn,tản,tấn,tần,tẩn,tận,tắn,tằn,tẳn,tặn
tandem	tandem
tang	tang,tàng,táng,tâng,tăng,tạng,tảng,tầng,tằng,tặng
tanh	tanh,tành,tánh,tạnh
tao	tao,tào,táo,tạo,tảo
tap	táp,tạp,tấp,tập,tắp
tapiro	tapiro
targa	targa
tat	tát,tạt,tất,tật,tắt
tata	tata
tau	tau,tàu,táu,tâu,tấu,tầu,tẩu,tậu
taunus	taunus
taurus	taurus
tay	tay,tày,táy,tây,tấy,tầy,tẩy
tazz	tazz
tc	tc
td	td
tdx	tdx
te	te,tè,té,tê,tẻ,tẽ,tế,tề,tể,tễ,tệ,te
teana	teana
tech	tếch
telstar	telstar
tem	tem,tèm,tém,têm
tempo	tempo
tempra	tempra
ten	ten,tên,tẽn
teng	teng
tenh	tênh,tểnh,tễnh
teo	teo,tèo,téo,tẹo,tẻo
tep	tép,tẹp,tệp
tepee	tepee
tercel	tercel
terios	terios
terra	terra
terracan	terracan
terracross	terracross
terradyne	terradyne
terrain	terrain
terrano	terrano
territory	territory
testarossa	testarossa
tet	tét,tẹt,tết
teu	têu,tếu
tf	tf
tha	tha,thà,thá,thả
thac	thác,thạc,thắc
thach	thách,thạch
thai	thai,thài,thái,thãi,thải
tham	tham,thám,thâm,thăm,thảm,thấm,thầm,thẩm,thẫm,thậm,thắm,thẳm
than	than,thán,thân,thăn,thản,thần,thẩn,thẫn,thận,thắn,thằn
thang	thang,tháng,thăng,thảng,thắng,thằng,thẳng,thặng
thanh	thanh,thành,thánh,thạnh,thảnh
thao	thao,thào,tháo,thạo,thảo
thap	tháp,thạp,thấp,thập,thắp
that	thát,thất,thật,thắt
thau	thau,tháu,thâu,thấu,thầu,thẩu
thay	thay,thày,thây,thảy,thấy,thầy
the	the,thè,thé,thê,thẻ,thẽ,thế,thề,thể,thệ
thech	thếch
them	thèm,thêm,thềm
then	then,thèn,thẹn,thện
thenh	thênh
theo	theo,thèo,thẹo,thẻo
thep	thép,thếp
thet	thét,thết
theu	thêu,thều,thểu
thi	thi,thì,thí,thĩ,thỉ,thị
thia	thia,thìa,thía
thich	thích,thịch
thiec	thiếc
thiem	thiêm,thiểm
thien	thiên,thiền,thiển,thiện
thieng	thiêng,thiềng
thiep	thiếp,thiệp
thiet	thiết,thiệt
thieu	thiêu,thiếu,thiều,thiểu,thiệu
thim	thím
thin	thin,thìn,thín
thinh	thinh,thình,thính,thỉnh,thịnh
think	think
thit	thít,thịt
thiu	thiu,thìu,thỉu
tho	tho,thò,thó,thô,thơ,thọ,thỏ,thố,thồ,thổ,thớ,thờ,thở,thợ
thoa	thoa,thòa,thóa,thõa,thỏa
thoai	thoai,thoái,thoại,thoải
thoan	thoán,thoăn
thoang	thoang,thoáng,thoảng,thoắng
thoat	thoát,thoạt,thoắt
thoc	thóc,thọc,thốc,thộc
thoi	thoi,thòi,thói,thôi,thơi,thỏi,thối,thổi,thới,thời
thom	thom,thòm,thóm,thơm,thỏm,thồm,thớm
thon	thon,thôn,thơn,thốn,thồn,thổn,thỗn,thộn
thong	thong,thòng,thông,thõng,thống
thop	thóp,thộp
thot	thót,thọt,thốt,thột,thớt
thu	thu,thù,thú,thư,thụ,thủ,thứ,thừ,thử,thự
thua	thua,thùa,thưa,thủa,thừa,thửa
thuan	thuần,thuẫn,thuận
thuat	thuật
thuc	thúc,thục,thức,thực
thue	thuê,thuế
thui	thui,thùi,thúi,thụi,thủi
thum	thum,thùm,thủm
thun	thun
thunder	thunder
thunderbird	thunderbird
thunderbolt	thunderbolt
thung	thung,thùng,thúng,thũng,thưng,thụng,thủng,thừng,thững
thuo	thuở
thuoc	thuốc,thuộc,thước,thược
thuoi	thưỡi
thuom	thuộm
thuon	thuôn,thuốn,thuồn,thuỗn,thườn,thưỡn
thuong	thuồng,thuổng,thương,thường,thưởng,thượng
thuot	thướt,thượt
thup	thụp
thut	thút,thụt
thuy	thùy,thúy,thụy,thủy
thuyen	thuyên,thuyền
thuyet	thuyết
ti	ti,tì,tí,tĩ,tỉ,tị
tia	tia,tía,tỉa,tịa
tiara	tiara
tiburon	tiburon
tich	tích,tịch
tiec	tiếc,tiệc
tiem	tiêm,tiếm,tiềm,tiệm
tien	tiên,tiến,tiền,tiễn,tiện
tieng	tiêng,tiếng,tiềng
tiep	tiếp,tiệp
tiet	tiết,tiệt
tieu	tiêu,tiếu,tiều,tiểu,tiễu
tiggo	tiggo
tigra	tigra
tiguan	tiguan
tiida	tiida
tim	tim,tìm,tím,tỉm
tin	tin,tín,tĩn
tinh	tinh,tình,tính,tĩnh,tỉnh,tịnh
tip	típ
tipo	tipo
tipper	tipper
tit	tít,tịt
titan	titan
tiu	tiu,tíu,tĩu,tịu
tivoli	tivoli
tl	tl
to	to,tò,tó,tô,tơ,tỏ,tố,tồ,tổ,tộ,tớ,tờ,tở,tợ
toa	toa,tòa,tóa,tọa,tỏa
toac	toác,toạc
toai	toài,toái,toại
toan	toan,toàn,toán,toản
toang	toang,toàng,toáng,toạng
toanh	toanh
toano	toano
toat	toát
toay	toáy
toc	tóc,tọc,tốc,tộc
tocsa	tocsa
toe	toe,tòe,tóe,tõe,tỏe
toen	toen,toèn
toet	toét,toẹt
toi	toi,tòi,tói,tôi,tơi,tỏi,tối,tồi,tội,tới,tời
tom	tom,tòm,tóm,tôm,tõm,tởm
ton	ton,tòn,tôn,tốn,tồn,tổn,tớn,tởn,tợn
tong	tong,tòng,tông,tọng,tỏng,tống,tồng,tổng
tonka	tonka
toong	toong,toòng
top	tóp,tọp,tốp,tợp
toplander	toplander
torino	torino
tornado	tornado
torneo	torneo
tot	tót,tọt,tốt,tột
touareg	touareg
touran	touran
town	town
towner	towner
toyota	toyota
tr	tr
tra	tra,trà,trá,trã,trả
trac	trác,trạc,trắc,trặc
tracer	tracer
trach	trách,trạch
tracker	tracker
tractor	tractor
trai	trai,trái,trại,trải
trail	trail
trailblazer	trailblazer
trailhawk	trailhawk
trailrunner	trailrunner
trajet	trajet
tram	tràm,trám,trâm,trăm,trạm,trảm,trầm,trẩm,trẫm,trậm,trắm,trằm
tran	tràn,trán,trân,trăn,trấn,trần,trận,trằn,trặn
trang	trang,tràng,tráng,trâng,trăng,trạng,trảng,trắng
tranh	tranh,trành,tránh,trạnh
trans	trans
transit	transit
transporter	transporter
transvan	transvan
trao	trao,trào,tráo,trạo,trảo
trap	tráp,trấp,trập
trat	trát,trạt,trật,trắt
trau	trau,tràu,trâu,trảu,trấu,trầu,trẩu
traveller	traveller
traverse	traverse
traviq	traviq
trax	trax
tray	trây,trảy,trầy,trẩy
tre	tre,trê,trẹ,trẻ,trẽ,trề,trễ,trệ
trech	trệch
trekker	trekker
trem	trèm
tren	trên,trẽn,trển
trenh	trếnh
treo	treo,trèo,tréo,trẹo,trẻo
tret	trét,trẹt,trết,trệt
treu	trêu,trếu,trệu
trevis	trevis
tri	tri,trì,trí,trĩ,trị
tria	trỉa
triax	triax
tribeca	tribeca
tribute	tribute
trich	trích,trịch
trien	triền,triển,triện
trieng	triêng,triềng
triet	triết,triệt
trieu	triều,triệu
trinh	trinh,trình,trĩnh,trịnh
trit	trít,trịt
triton	triton
triu	trìu,tríu,trĩu
trixx	trixx
tro	tro,trò,trô,trơ,trọ,trỏ,trố,trồ,trổ,trỗ,trộ,trớ,trờ,trở,trợ
troc	tróc,trọc,trốc
troi	tròi,trói,trôi,trơi,trọi,trối,trồi,trổi,trỗi,trội,trời
trom	trom,tròm,trõm,trộm
tron	tròn,trôn,trơn,trọn,trốn,trộn,trớn,trợn
trong	trong,tròng,tróng,trông,trọng,trỏng,trống,trồng,trổng,trộng
trooper	trooper
trot	trót,trọt,trốt,trớt,trợt
tru	tru,trù,trú,trụ,trủ,trứ,trừ,trữ,trự
trua	trưa,trụa
truan	truân
truat	truất
truc	trúc,trục,trực
truck	truck
trui	trui,trùi,trũi,trụi
trum	trùm,trúm,trụm
trun	trùn
trung	trung,trùng,trúng,trũng,trưng,trụng,trứng,trừng,trửng
truoc	trước
truon	trườn
truong	truông,truồng,trương,trướng,trường,trưởng,trưỡng,trượng
truot	trượt
trut	trút,trụt
truu	trừu
truy	truy,trùy,trụy
truyen	truyền,truyện
ts	ts
tsx	tsx
tt	tt
tts	tts
tu	tu,tù,tú,tư,tụ,tủ,tứ,từ,tử,tự
tua	tua,túa,tưa,tủa,tứa,tựa
tuan	tuân,tuấn,tuần,tuẫn
tuat	tuất
tuc	túc,tục,tức
tucson	tucson
tue	tuế,tuệ
tuech	tuếch
tuenh	tuềnh
tui	tui,túi,tụi,tủi
tum	tum,tùm,túm,tũm,tụm,tủm
tun	tun,tủn
tundra	tundra
tung	tung,tùng,túng,tưng,tụng,từng,tửng
tuoc	tuốc,tuộc,tước,tược
tuoi	tuồi,tuổi,tươi,tưới,tưởi
tuom	tươm
tuon	tuôn,tuốn,tuồn
tuong	tuông,tuồng,tương,tướng,tường,tưởng,tượng
tuop	tướp
tuot	tuốt,tuột,tướt,tượt
tuou	tườu
tup	túp
turbo	turbo
turismo	turismo
tut	tút,tụt
tuu	tửu,tựu
tuy	tuy,tùy,túy,tụy,tủy
tuya	tuya
tuyen	tuyên,tuyến,tuyền,tuyển
tuyet	tuyết,tuyệt
tuyn	tuyn
tuyp	tuýp
tuyt	tuýt
twin	twin
type	type
typhoon	typhoon
u	u,ù,ú,ư,ụ,ủ,ứ,ừ,ử,u
u4	u4
ua	ùa,úa,ưa,ủa,ứa,ựa
uan	uẩn
uat	uất
uc	úc,ục,ức,ực
ue	uế,uể
ui	ui,úi,ủi
ulysse	ulysse
um	um,ùm,úm
un	un,ùn,ủn
ung	ung,ùng,úng,ưng,ủng,ứng,ừng,ửng
univan	univan
unlimited	unlimited
uno	uno
uoc	ước
uoi	ươi
uom	uôm,ươm,ướm
uon	uốn,ươn,ườn,ưỡn
uong	uống,uổng,ương
uop	ướp
uot	uột,ướt
up	úp,ụp,up
uplander	uplander
ur	ur
urban	urban
urvan	urvan
ut	út,ụt
uu	ưu
uy	uy,úy,ủy
uych	uỵch
uyen	uyên,uyển
uynh	uỳnh
v	v
v12	v12
v2	v2
v40	v40
v5	v5
v50	v50
v60	v60
v70	v70
v8	v8
v80	v80
v90	v90
va	va,và,vá,vã,vạ,vả
vac	vác,vạc,vắc,vặc
vach	vách,vạch
vada	vada
vai	vai,vài,vái,vãi,vại,vải
valiant	valiant
valley	valley
vam	vàm,vâm,vạm,vậm,vằm
vamos	vamos
van	van,vàn,ván,vân,văn,vạn,vấn,vần,vẩn,vẫn,vận,vắn,vằn,vặn,van
vanden	vanden
vaneo	vaneo
vanette	vanette
vang	vang,vàng,váng,vâng,vãng,văng,vạng,vảng,vầng,vắng,vằng,vẳng
vanh	vanh,vành,vánh,vãnh,vạnh,vảnh
vanquish	vanquish
vantage	vantage
vao	vao,vào,váo
vap	váp,vạp,vấp,vập
varsity	varsity
vat	vát,vạt,vất,vật,vắt,vặt
vau	vấu,vầu,vẩu
vay	vay,vày,váy,vây,vạy,vảy,vấy,vầy,vẩy,vẫy,vậy
ve	ve,vè,vé,vê,vẻ,vẽ,vế,về,vệ
vec	véc,vẹc
vech	vếch
vectra	vectra
vedette	vedette
vega	vega
vehicross	vehicross
veloster	veloster
vem	vẹm
ven	ven,vén,vên,vẹn,vẻn,vền,vện
venga	venga
venh	vênh,vểnh
venom	venom
vento	vento
venture	venture
venza	venza
veo	veo,vèo,véo,vẹo,vẻo
veracruz	veracruz
verada	verada
verisa	verisa
verita	verita
veritas	veritas
verona	verona
verossa	verossa
versa	versa
versailles	versailles
version	version
verso	verso
vet	vét,vẹt,vết,vệt
veu	vêu,vếu,vều
vi	vi,vì,ví,vĩ,vỉ,vị,vi
via	vía,vỉa
viano	viano
vich	vích
victoria	victoria
viec	việc
viem	viêm
vien	viên,viền,viển,viễn,viện
vieng	viếng
viet	viết,việt
view	view
vigor	vigor
vii	vii
viii	viii
villager	villager
vim	vịm
vin	vin,vịn
vinh	vinh,vĩnh,vịnh
violet	violet
vios	vios
viper	viper
virage	virage
vision	vision
vista	vista
visto	visto
vit	vít,vịt
vita	vita
vitara	vitara
vito	vito
vitz	vitz
viu	víu
viva	viva
vivace	vivace
vivant	vivant
vivaro	vivaro
vivio	vivio
vizon	vizon
vo	vo,vò,vó,vô,võ,vơ,vọ,vỏ,vố,vồ,vổ,vỗ,vớ,vờ,vở,vỡ,vợ
voan	voan
voc	vóc,vọc,vốc
voi	voi,vòi,vói,vôi,vơi,vọi,vối,vội,với,vời,vợi
volante	volante
voleex	voleex
volkswagen	volkswagen
volt	volt
volvo	volvo
vom	vòm
von	von,vòn,vón,vôn,vỏn,vốn,vồn,vờn,vởn
vong	vong,vòng,vóng,vông,võng,vọng,vỏng,vống,vồng,vổng
vop	vọp
vot	vót,vọt,vớt,vợt
voyager	voyager
vu	vu,vù,vú,vũ,vụ
vua	vua,vùa,vừa,vữa,vựa
vuc	vúc,vục,vức,vực
vui	vui,vùi
vum	vũm
vun	vun,vùn,vụn
vung	vung,vùng,vũng,vụng,vừng,vửng,vững,vựng
vuoc	vược
vuon	vươn,vườn,vượn
vuong	vuông,vương,vướng,vưởng,vượng
vuot	vuốt,vuột,vượt
vut	vút,vụt,vứt
vx	vx
vx4	vx4
w	w
w12	w12
w124	w124
wagon	wagon
wagoneer	wagoneer
wall	wall
washu	washu
wc	wc
weekend	weekend
wheeler	wheeler
wigo	wigo
will	will
willys	willys
wind	wind
windom	windom
windsor	windsor
windstar	windstar
wingle	wingle
wira	wira
wizard	wizard
wraith	wraith
wrangler	wrangler
wrx	wrx
wx	wx
x	x
x1	x1
x10	x10
x2	x2
x20	x20
x3	x3
x4	x4
x400	x400
x424	x424
x5	x5
x6	x6
x80	x80
x90	x90
xa	xa,xà,xá,xã,xạ,xả,xa
xac	xác,xạc,xấc,xắc
xach	xách,xạch
xai	xài,xái,xải
xam	xam,xàm,xám,xâm,xăm,xạm,xảm,xầm,xẩm,xắm
xan	xan,xán,xăn,xẩn,xắn
xang	xang,xàng,xáng,xăng,xằng,xẵng
xanh	xanh
xao	xao,xào,xáo,xạo,xảo
xap	xáp,xấp,xập,xắp
xat	xát,xắt
xau	xàu,xâu,xảu,xấu,xầu,xẩu
xay	xay,xáy,xây,xảy,xẩy
xb	xb
xc60	xc60
xc70	xc70
xc90	xc90
xd	xd
xe	xe,xè,xé,xê,xẻ,xế,xề,xể,xệ,xe
xech	xếch,xệch
xedos	xedos
xem	xem,xềm
xen	xen,xèn,xén,xên,xẻn
xeng	xèng,xẻng
xenh	xênh,xềnh,xểnh
xenon	xenon
xeo	xeo,xèo,xéo,xẹo,xẻo,xẽo
xep	xép,xẹp,xếp,xệp
xet	xét,xẹt,xệt
xeu	xêu,xều
xf	xf
xfr	xfr
xg	xg
xi	xi,xì,xí,xỉ,xị
xia	xìa,xía,xỉa
xich	xích
xiec	xiếc
xiem	xiêm,xiểm
xien	xiên
xieng	xiềng,xiểng
xiet	xiết
xieu	xiêu
xin	xin,xỉn
xinh	xinh,xình,xính,xĩnh,xỉnh
xit	xít,xịt
xiu	xìu,xíu,xỉu,xịu
xj	xj
xj220	xj220
xj6	xj6
xj8	xj8
xjl	xjl
xjr	xjr
xjs	xjs
xk	xk
xk8	xk8
xkr	xkr
xl	xl
xl6	xl6
xl7	xl7
xlr	xlr
xo	xo,xó,xô,xơ,xọ,xỏ,xố,xồ,xổ,xớ,xờ,xở,xỡ
xoa	xoa,xòa,xóa,xõa,xỏa
xoac	xoác,xoạc
xoach	xoạch
xoai	xoai,xoài,xoải
xoam	xòam
xoan	xoan,xoàn,xoăn,xoắn,xoẳn
xoang	xoang,xoàng,xoảng
xoanh	xoành
xoat	xoát,xoạt
xoay	xoay,xoáy
xoc	xóc,xọc,xốc,xộc
xoe	xoe,xòe
xoen	xoen,xoèn
xoet	xoét,xoẹt
xoi	xoi,xói,xôi,xơi,xối,xổi,xới,xởi
xom	xom,xóm,xôm,xơm,xồm,xổm,xờm
xon	xon,xón,xôn,xơn,xốn,xồn,xộn
xong	xong,xông,xõng,xống,xồng,xổng
xoong	xoong
xop	xọp,xốp,xộp
xot	xót,xốt,xớt
xp	xp
xplod	xplod
xpower	xpower
xr	xr
xt	xt
xterra	xterra
xts	xts
xu	xu,xù,xú,xũ,xụ,xứ,xừ,xử,xự
xua	xua,xưa,xửa
xuan	xuân,xuẩn
xuat	xuất
xuc	xúc,xục,xức,xực
xue	xuê,xuề,xuể
xuech	xuệch
xuenh	xuềnh
xui	xui,xùi,xúi,xụi
xum	xum,xùm,xúm
xun	xun
xung	xung,xùng,xúng,xưng,xủng,xứng,xừng,xửng
xuoc	xước,xược
xuoi	xuôi
xuom	xuộm
xuong	xuống,xuồng,xuổng,xương,xướng,xường,xưởng
xup	xụp
xut	xút
xuv	xuv
xuy	xùy,xúy
xuya	xuya
xuyen	xuyên,xuyến
xuyet	xuyết
xuyt	xuýt,xuỵt
xv	xv
xvl	xvl
xylo	xylo
xyr	xyr
y	y,ý,ỳ,ỷ
yaris	yaris
yb	yb
ycc	ycc
yem	yếm,yểm
yen	yên,yến
yeng	yêng,yểng
yet	yết
yeu	yêu,yếu,yểu
yorker	yorker
ypsilon	ypsilon
yrv	yrv
yukon	yukon
z	z
z1	z1
z18	z18
z22	z22
z3	z3
z4	z4
z8	z8
z9	z9
zafira	zafira
zaroot	zaroot
zdx	zdx
zephyr	zephyr
zodiac	zodiac
zr	zr
zs	zs
zt	zt
zx	zx
zxs	zxs
đa	đa,đà,đá,đã,đả
đac	đác,đạc,đắc,đặc
đach	đách,đạch
đai	đai,đài,đái,đãi,đại
đam	đam,đàm,đám,đâm,đăm,đạm,đảm,đấm,đầm,đẫm,đậm,đắm,đằm,đẵm,đặm
đan	đan,đàn,đán,đạn,đản,đần,đẫn,đận,đắn,đằn,đẵn,đặn
đang	đang,đàng,đáng,đãng,đăng,đảng,đấng,đắng,đằng,đẳng,đẵng,đặng
đanh	đanh,đành,đánh,đảnh
đao	đao,đào,đáo,đạo,đảo
đap	đáp,đạp,đập,đắp
đat	đát,đạt,đất,đật,đắt,đặt
đau	đau,đáu,đâu,đấu,đầu,đẩu,đậu
đay	đay,đày,đáy,đây,đãy,đảy,đấy,đầy,đẩy,đẫy,đậy
đe	đe,đè,đé,đê,đẻ,đẽ,đế,đề,để,đễ,đệ
đec	đéc
đech	đếch
đem	đem,đèm,đém,đêm,đếm,đềm,đệm
đen	đen,đèn,đẹn,đến,đền
đenh	đênh,đềnh,đểnh
đeo	đeo,đèo,đéo,đẽo
đep	đẹp,đệp
đet	đét,đẹt
đeu	đêu,đều,đểu
đi	đi,đì,đĩ
đia	đìa,đĩa,đỉa,địa
đich	đích,địch
điec	điếc
điem	điêm,điếm,điềm,điểm,điệm
đien	điên,điến,điền,điển,điện
đieng	điêng,điếng
điep	điệp
đieu	điêu,điếu,điều,điểu,điệu
đin	đin
đinh	đinh,đình,đính,đĩnh,đỉnh,định
đit	đít,địt
điu	điu,đìu,địu
đo	đo,đò,đó,đô,đõ,đơ,đọ,đỏ,đố,đồ,đổ,đỗ,độ,đớ,đờ,đỡ,đợ
đoa	đóa,đọa
đoac	đoác
đoai	đoài,đoái
đoan	đoan,đoàn,đoán,đoạn,đoản
đoang	đoàng,đoảng
đoanh	đoành
đoat	đoạt
đoc	đọc,đốc,độc
đoi	đòi,đói,đôi,đọi,đỏi,đối,đồi,đổi,đỗi,đội,đới,đời,đợi
đom	đom,đóm,đôm,đơm,đỏm,đốm,đồm,đờm,đởm
đon	đon,đòn,đón,đôn,đơn,đọn,đốn,đồn,độn,đớn,đờn,đởn
đong	đong,đòng,đóng,đông,đọng,đỏng,đống,đồng,đổng,động
đop	đốp,độp,đớp
đot	đót,đọt,đốt,đột,đớt,đợt
đu	đu,đù,đú,đụ,đủ,đứ,đừ,đử
đua	đua,đùa,đúa,đũa,đưa,đứa
đuc	đúc,đục,đức,đực
đuenh	đuềnh,đuểnh
đui	đui,đùi,đũi,đủi
đum	đum,đùm,đúm
đun	đun,đùn,đụn
đung	đung,đùng,đúng,đũng,đưng,đụng,đủng,đứng,đừng,đựng
đuoc	đuốc,đước,được
đuoi	đuôi,đuối,đuổi,đười
đuom	đượm
đuon	đuồn,đuỗn,đườn,đưỡn
đuong	đuống,đương,đường
đuot	đuột
đup	đúp,đụp
đut	đút,đụt,đứt